ELEC_CD	ELEC_SIDO	ELEC_GU	ELEC_EMD	POPU_ALL	VOTER	C01	C02	C03	C04	C05	C06	C07	C08	C09	C10	C11	C12	VOTE_VAL	VOTE_INVAL	NON_VOTER
110101	서울특별시	종로구	청운효자동	8706	6640	3150	3137	237	3	26	2	0	3	7	4	1	2	6572	68	2066
110103	서울특별시	종로구	사직동	7651	5850	2260	3282	212	3	22	0	1	2	4	4	0	0	5790	60	1801
110104	서울특별시	종로구	삼청동	1935	1443	591	767	51	0	10	0	0	3	3	0	0	0	1425	18	492
110105	서울특별시	종로구	부암동	7205	5485	2496	2731	154	0	26	4	0	4	0	4	1	2	5422	63	1720
110106	서울특별시	종로구	평창동	13796	10534	3866	6248	266	5	35	7	1	6	8	11	0	2	10455	79	3262
110107	서울특별시	종로구	무악동	6143	4978	2162	2586	155	3	17	0	1	0	2	3	2	2	4933	45	1165
110108	서울특별시	종로구	교남동	7795	6215	2621	3276	193	3	28	1	0	2	9	11	2	1	6147	68	1580
110109	서울특별시	종로구	가회동	3454	2650	1252	1243	104	2	10	1	0	2	2	4	1	2	2623	27	804
110110	서울특별시	종로구	종로1·2·3·4가동	5741	3527	1468	1911	81	2	17	0	1	1	2	4	3	0	3490	37	2214
110111	서울특별시	종로구	종로5·6가동	4130	2906	1305	1460	76	0	23	0	0	1	2	0	0	2	2869	37	1224
110112	서울특별시	종로구	이화동	6154	4703	2279	2141	174	2	23	1	1	4	5	8	1	1	4640	63	1451
110113	서울특별시	종로구	혜화동	12828	9743	4400	4752	364	15	47	12	0	5	9	6	1	5	9616	127	3085
110115	서울특별시	종로구	창신제1동	5152	3907	2134	1580	90	0	37	2	1	1	6	4	2	2	3859	48	1245
110116	서울특별시	종로구	창신제2동	6071	4089	2262	1633	78	2	35	3	0	4	7	3	1	3	4031	58	1982
110117	서울특별시	종로구	창신제3동	5236	4067	2036	1848	109	1	16	1	0	4	3	3	0	0	4021	46	1169
110118	서울특별시	종로구	숭인제1동	4575	3286	1641	1489	84	1	26	1	1	2	1	1	1	0	3248	38	1289
110119	서울특별시	종로구	숭인제2동	7970	5605	2866	2394	185	0	49	3	1	1	9	10	2	2	5522	83	2365
110201	서울특별시	중구	소공동	1747	1296	489	734	50	1	6	2	0	0	0	3	1	0	1286	10	451
110202	서울특별시	중구	회현동	3883	2519	965	1460	50	0	15	2	0	2	3	0	0	0	2497	22	1364
110203	서울특별시	중구	명동	2150	1515	593	860	37	1	12	0	0	1	2	0	1	0	1507	8	635
110204	서울특별시	중구	필동	3998	3081	1396	1550	73	1	17	0	0	2	4	2	0	0	3045	36	917
110205	서울특별시	중구	장충동	3940	2902	1316	1437	81	2	26	0	0	1	2	2	0	1	2868	34	1038
110206	서울특별시	중구	광희동	3757	2435	928	1389	65	0	13	0	0	0	1	2	1	0	2399	36	1322
110207	서울특별시	중구	을지로동	1478	987	390	559	25	1	4	0	0	0	1	0	0	0	980	7	491
110208	서울특별시	중구	신당동	7063	5048	2400	2422	124	5	37	1	1	1	2	3	2	1	4999	49	2015
110209	서울특별시	중구	다산동	10155	7101	3350	3391	211	10	45	1	0	0	7	6	2	6	7029	72	3054
110210	서울특별시	중구	약수동	13658	10613	4561	5623	279	4	40	4	1	3	12	5	4	4	10540	73	3045
110211	서울특별시	중구	청구동	10615	8150	3605	4209	202	7	34	2	2	0	6	1	1	3	8072	78	2465
110212	서울특별시	중구	신당제5동	8626	6268	3043	2946	173	0	34	1	1	0	6	8	2	1	6215	53	2358
110213	서울특별시	중구	동화동	8177	6359	2818	3280	179	4	23	0	0	0	4	0	1	4	6313	46	1818
110214	서울특별시	중구	황학동	10175	7288	3380	3581	194	2	41	1	3	5	5	4	0	0	7216	72	2887
110215	서울특별시	중구	중림동	8899	6768	2957	3523	191	2	32	1	1	0	5	4	1	0	6717	51	2131
110301	서울특별시	용산구	후암동	13481	9953	4853	4642	290	3	50	5	0	2	6	8	6	0	9865	88	3528
110302	서울특별시	용산구	용산2가동	7867	5534	2623	2577	211	5	42	1	1	5	7	4	0	3	5479	55	2333
110303	서울특별시	용산구	남영동	6698	4404	2095	2040	142	5	44	2	1	3	4	11	1	1	4349	55	2294
110304	서울특별시	용산구	청파동	14261	9913	4920	4385	394	6	65	5	0	3	8	9	5	7	9807	106	4348
110306	서울특별시	용산구	원효로제1동	12787	10037	4104	5443	348	4	33	3	0	3	6	5	1	4	9954	83	2750
110307	서울특별시	용산구	원효로제2동	10135	7789	3334	4108	230	3	40	1	4	3	2	3	1	2	7731	58	2346
110308	서울특별시	용산구	효창동	8076	6423	2856	3276	193	1	28	1	0	1	2	4	0	1	6363	60	1653
110309	서울특별시	용산구	용문동	9790	7570	3464	3723	255	5	42	0	1	2	7	10	1	2	7512	58	2220
110310	서울특별시	용산구	한강로동	16116	12170	3795	7863	355	2	39	1	1	4	4	3	2	0	12069	101	3946
110313	서울특별시	용산구	이촌제1동	19821	15471	3666	11389	299	3	29	2	5	6	5	4	2	1	15411	60	4350
110314	서울특별시	용산구	이촌제2동	6556	5164	1955	3024	110	2	23	0	5	1	6	4	0	1	5131	33	1392
110315	서울특별시	용산구	이태원제1동	5787	4139	1517	2441	120	3	25	2	0	1	0	2	0	0	4111	28	1648
110316	서울특별시	용산구	이태원제2동	7333	5048	1984	2790	154	5	30	2	1	2	8	3	3	2	4984	64	2285
110317	서울특별시	용산구	한남동	15402	10290	3403	6486	252	4	44	1	0	6	6	4	0	3	10209	81	5112
110319	서울특별시	용산구	서빙고동	9048	6715	1922	4562	131	2	41	2	0	5	2	0	0	3	6670	45	2333
110320	서울특별시	용산구	보광동	11688	8133	3554	4206	231	3	59	4	0	2	6	3	1	5	8074	59	3555
110401	서울특별시	성동구	금호1가동	11395	8615	3669	4609	202	3	36	2	0	1	8	4	3	1	8538	77	2780
110402	서울특별시	성동구	금호2·3가동	17159	12722	5545	6659	320	9	54	3	2	0	9	8	3	6	12618	104	4437
110404	서울특별시	성동구	금호4가동	11719	9107	3727	5049	193	4	50	2	1	5	3	8	1	5	9048	59	2612
110405	서울특별시	성동구	옥수동	19705	15269	5114	9615	354	11	49	3	4	3	13	6	3	3	15178	91	4436
110407	서울특별시	성동구	응봉동	12309	9673	4203	5082	250	5	39	0	0	4	6	3	3	1	9596	77	2636
110408	서울특별시	성동구	성수1가제1동	12061	8894	3419	5080	253	4	42	0	2	3	4	5	1	1	8814	80	3167
110409	서울특별시	성동구	성수1가제2동	11161	8997	3735	4811	302	4	38	4	0	2	2	9	2	3	8912	85	2164
110410	서울특별시	성동구	성수2가제1동	13255	9814	4280	5106	254	6	52	3	2	4	7	9	1	4	9728	86	3441
110411	서울특별시	성동구	성수2가제3동	8984	6829	2790	3742	174	5	43	1	1	1	2	5	0	3	6767	62	2155
110412	서울특별시	성동구	왕십리도선동	20176	15381	6374	8326	436	4	66	5	2	0	7	9	3	4	15236	145	4795
110413	서울특별시	성동구	왕십리제2동	13477	10436	4998	4916	337	10	46	4	1	3	8	11	3	2	10339	97	3041
110415	서울특별시	성동구	행당제1동	11647	9172	3732	5021	264	2	36	2	1	2	7	5	1	4	9077	95	2475
110416	서울특별시	성동구	행당제2동	17334	13587	5828	7167	375	8	63	3	1	5	10	10	1	7	13478	109	3747
110417	서울특별시	성동구	마장동	17471	13080	6010	6415	362	5	90	5	1	4	16	11	0	4	12923	157	4391
110418	서울특별시	성동구	사근동	8737	6159	2597	3160	212	9	38	1	0	4	1	4	1	3	6030	129	2578
110419	서울특별시	성동구	송정동	8401	5932	2881	2776	159	8	31	1	0	0	6	3	2	1	5868	64	2469
110420	서울특별시	성동구	용답동	9544	6689	3393	3006	162	4	32	3	0	1	4	5	2	3	6615	74	2855
110501	서울특별시	광진구	중곡제1동	12535	9135	4617	4063	276	4	69	3	4	0	3	3	1	2	9045	90	3400
110502	서울특별시	광진구	중곡제2동	17181	12522	6232	5619	396	16	79	1	3	5	14	17	3	10	12395	127	4659
110503	서울특별시	광진구	중곡제3동	13288	9549	4682	4371	266	10	92	0	1	4	6	6	3	4	9445	104	3739
110504	서울특별시	광진구	중곡제4동	23814	17762	8871	8061	474	8	139	2	3	3	24	15	2	7	17609	153	6052
110505	서울특별시	광진구	능동	9582	7416	3601	3391	269	8	40	4	0	2	10	4	1	4	7334	82	2166
110506	서울특별시	광진구	구의제1동	18672	13974	6834	6394	455	7	96	6	3	5	11	8	4	5	13828	146	4698
110507	서울특별시	광진구	구의제2동	20422	15377	7679	6977	435	9	87	3	4	1	16	14	1	5	15231	146	5045
110508	서울특별시	광진구	구의제3동	22047	17486	7030	9721	481	9	60	4	0	7	10	6	3	7	17338	148	4561
110509	서울특별시	광진구	광장동	24208	19394	7687	11008	490	6	36	4	5	3	10	4	3	1	19257	137	4814
110510	서울특별시	광진구	자양제1동	19073	14158	7087	6348	442	6	84	5	1	7	8	12	4	1	14005	153	4915
110511	서울특별시	광진구	자양제2동	18091	13516	6408	6520	371	6	73	5	1	5	14	12	0	3	13418	98	4575
110512	서울특별시	광진구	자양제3동	22009	17772	7147	9972	441	6	48	1	0	4	15	5	1	11	17651	121	4237
110513	서울특별시	광진구	자양제4동	15204	11184	5076	5595	300	9	71	2	2	3	10	8	1	5	11082	102	4020
110515	서울특별시	광진구	화양동	20156	13853	6192	6661	558	13	108	3	1	3	7	11	4	6	13567	286	6303
110516	서울특별시	광진구	군자동	15611	11347	5410	5245	384	14	88	1	1	2	14	9	3	2	11173	174	4264
110601	서울특별시	동대문구	용신동	25435	17841	8226	8759	492	10	110	4	2	4	22	15	2	5	17651	190	7594
110602	서울특별시	동대문구	제기동	19508	14050	6173	7227	375	9	78	1	4	6	18	5	10	9	13915	135	5458
110603	서울특별시	동대문구	전농제1동	22141	16093	7304	8033	421	10	88	3	2	8	9	17	6	7	15908	185	6048
110604	서울특별시	동대문구	전농제2동	15681	12218	5705	6047	274	8	52	3	2	3	9	9	0	3	12115	103	3463
110605	서울특별시	동대문구	답십리제1동	22114	16956	7763	8468	448	18	65	1	3	1	12	14	1	6	16800	156	5158
110606	서울특별시	동대문구	답십리제2동	21777	16627	7897	8086	388	5	82	3	2	4	12	14	4	5	16502	125	5150
110607	서울특별시	동대문구	장안제1동	30784	22762	11171	10632	578	11	138	5	6	2	14	10	3	4	22574	188	8022
110608	서울특별시	동대문구	장안제2동	26063	19568	9600	9265	446	15	92	3	1	2	11	10	5	8	19458	110	6495
110609	서울특별시	동대문구	청량리동	15766	11726	4992	6211	263	7	83	2	1	7	16	8	8	3	11601	125	4040
110610	서울특별시	동대문구	회기동	10692	8522	3659	4296	334	11	53	2	0	0	4	8	6	0	8373	149	2170
110611	서울특별시	동대문구	휘경제1동	10682	7939	3550	3981	236	5	36	1	0	4	4	9	1	3	7830	109	2743
110612	서울특별시	동대문구	휘경제2동	17216	12700	5757	6306	385	7	75	4	1	2	11	7	7	4	12566	134	4516
110613	서울특별시	동대문구	이문제1동	13948	10256	4377	5303	344	9	57	1	3	0	9	11	9	3	10126	130	3692
110614	서울특별시	동대문구	이문제2동	14987	11389	5409	5476	297	5	57	1	0	6	10	16	8	5	11290	99	3598
110701	서울특별시	중랑구	면목본동	28015	19404	9857	8612	514	9	156	2	3	4	18	21	4	7	19207	197	8611
110702	서울특별시	중랑구	면목제2동	18742	12934	6526	5822	319	9	91	4	3	6	13	13	4	3	12813	121	5808
110703	서울특별시	중랑구	면목제3·8동	19809	13815	6846	6321	348	9	125	3	0	2	13	14	6	7	13694	121	5994
110704	서울특별시	중랑구	면목제4동	15323	10942	5469	4971	274	6	90	1	2	4	11	4	3	2	10837	105	4381
110705	서울특별시	중랑구	면목제5동	11853	8904	4678	3841	238	6	63	2	0	2	5	5	1	2	8843	61	2949
110707	서울특별시	중랑구	면목제7동	18086	13180	6433	6187	335	7	97	0	0	5	10	5	2	2	13083	97	4906
110709	서울특별시	중랑구	상봉제1동	16899	12310	5796	5923	338	6	92	5	3	5	13	8	2	7	12198	112	4589
110710	서울특별시	중랑구	상봉제2동	17063	11837	5961	5275	379	11	72	5	2	1	11	14	2	2	11735	102	5226
110711	서울특별시	중랑구	중화제1동	17007	12794	6352	5820	358	9	105	6	3	6	3	13	2	2	12679	115	4213
110712	서울특별시	중랑구	중화제2동	19070	12494	6355	5530	311	9	123	2	4	5	13	12	3	0	12367	127	6576
110714	서울특별시	중랑구	묵제1동	25776	19273	9153	9285	482	6	121	4	0	4	19	10	6	3	19093	180	6503
110715	서울특별시	중랑구	묵제2동	16512	12326	6309	5462	326	3	97	3	1	2	15	20	2	4	12244	82	4186
110716	서울특별시	중랑구	망우본동	27120	19670	9324	9515	468	11	129	7	4	4	22	20	5	2	19511	159	7450
110718	서울특별시	중랑구	망우제3동	15145	10959	5639	4794	258	11	112	1	1	3	19	14	4	9	10865	94	4186
110719	서울특별시	중랑구	신내제1동	27198	20680	9941	9873	529	12	113	4	1	7	13	13	7	4	20517	163	6518
110720	서울특별시	중랑구	신내제2동	20786	17179	8576	7801	489	7	90	3	1	6	20	20	4	6	17023	156	3607
110801	서울특별시	성북구	성북동	13366	10046	4788	4713	369	7	63	7	3	5	9	6	1	2	9973	73	3320
110804	서울특별시	성북구	삼선동	20789	15894	7989	7025	601	10	81	1	1	10	11	12	4	5	15750	144	4895
110806	서울특별시	성북구	동선동	12067	8614	4304	3750	380	8	54	3	0	1	2	9	1	4	8516	98	3453
110808	서울특별시	성북구	돈암제1동	12170	9679	4525	4679	318	4	34	3	1	1	12	13	1	5	9596	83	2491
110809	서울특별시	성북구	돈암제2동	17237	13623	6249	6766	415	2	58	2	0	1	10	8	4	1	13516	107	3614
110810	서울특별시	성북구	안암동	11838	8717	3781	4345	378	11	42	4	1	1	14	5	1	5	8588	129	3121
110811	서울특별시	성북구	보문동	11878	8510	4161	3916	272	5	41	1	0	4	5	7	1	3	8416	94	3368
110812	서울특별시	성북구	정릉제1동	14023	10973	5321	5194	295	5	43	1	3	0	3	3	2	3	10873	100	3050
110813	서울특별시	성북구	정릉제2동	17535	12994	6289	6126	341	13	83	3	1	4	11	10	3	4	12888	106	4541
110814	서울특별시	성북구	정릉제3동	10854	7451	3397	3671	219	5	61	2	3	0	6	3	3	2	7372	79	3403
110815	서울특별시	성북구	정릉제4동	19605	14720	7269	6806	400	8	83	9	2	6	14	15	5	6	14623	97	4885
110816	서울특별시	성북구	길음제1동	24527	19612	9387	9428	551	10	71	6	4	5	10	15	5	3	19495	117	4915
110818	서울특별시	성북구	길음제2동	13021	10075	4571	5071	282	2	51	1	1	5	10	8	3	1	10006	69	2946
110819	서울특별시	성북구	종암동	29977	22874	11159	10654	668	9	99	5	1	11	15	14	7	10	22652	222	7103
110821	서울특별시	성북구	월곡제1동	20405	15636	8305	6648	408	8	82	4	2	10	14	10	2	3	15496	140	4769
110822	서울특별시	성북구	월곡제2동	15741	11808	5837	5388	371	9	64	7	1	2	4	8	0	4	11695	113	3933
110826	서울특별시	성북구	장위제1동	18530	13157	6710	5891	311	6	82	10	2	3	10	13	6	6	13050	107	5373
110827	서울특별시	성북구	장위제2동	11319	7986	3852	3819	176	4	63	0	0	1	8	6	0	1	7930	56	3333
110828	서울특별시	성북구	장위제3동	11814	9181	4145	4638	258	1	37	4	0	4	8	12	1	1	9109	72	2633
110829	서울특별시	성북구	석관동	26636	18965	9034	9050	501	10	132	4	3	5	16	25	8	6	18794	171	7671
110901	서울특별시	강북구	삼양동	18693	13033	6985	5457	323	10	100	7	1	6	12	11	4	0	12916	117	5660
110903	서울특별시	강북구	미아동	19342	14122	7463	5920	417	10	106	2	1	3	15	19	9	5	13970	152	5220
110904	서울특별시	강북구	송중동	22194	15558	7815	7031	408	12	116	3	2	7	12	20	4	6	15436	122	6636
110905	서울특별시	강북구	송천동	21430	15146	7854	6639	381	8	107	5	3	3	11	19	2	3	15035	111	6284
110906	서울특별시	강북구	삼각산동	22797	18186	9355	8013	551	12	77	1	2	4	13	13	5	5	18051	135	4611
110915	서울특별시	강북구	우이동	16671	11950	5876	5525	298	5	95	8	2	2	7	11	4	2	11835	115	4721
110916	서울특별시	강북구	인수동	23853	16622	8537	7386	362	9	127	6	1	4	14	18	4	4	16472	150	7231
110917	서울특별시	강북구	번1동	15331	10314	5211	4616	250	5	80	2	3	1	20	11	2	1	10202	112	5017
110918	서울특별시	강북구	번2동	13125	9399	4907	4062	229	5	67	2	2	0	18	7	3	5	9307	92	3726
110919	서울특별시	강북구	번3동	13454	9839	4932	4487	240	10	54	1	2	4	11	6	4	5	9756	83	3615
110920	서울특별시	강북구	수유1동	17488	12051	6381	5082	319	5	100	0	3	5	14	11	6	6	11932	119	5437
110921	서울특별시	강북구	수유2동	17561	12876	6299	6030	293	12	98	3	1	2	11	9	5	7	12770	106	4685
110922	서울특별시	강북구	수유3동	20635	14415	7319	6312	391	10	149	10	0	5	8	21	3	7	14235	180	6220
111001	서울특별시	도봉구	쌍문1동	16362	11605	5938	5130	305	9	83	2	4	3	11	16	3	2	11506	99	4757
111002	서울특별시	도봉구	쌍문2동	15533	11271	5575	5187	291	8	93	1	1	3	3	8	2	3	11175	96	4262
111003	서울특별시	도봉구	쌍문3동	13770	9962	5022	4482	260	3	69	2	3	2	8	11	1	2	9865	97	3808
111004	서울특별시	도봉구	쌍문4동	13550	10492	4945	5062	316	9	64	0	4	3	5	6	1	3	10418	74	3058
111005	서울특별시	도봉구	방학1동	21563	15256	7294	7321	383	8	95	1	3	3	9	15	4	5	15141	115	6307
111006	서울특별시	도봉구	방학2동	16480	11621	5998	5155	245	9	95	2	1	5	8	13	3	1	11535	86	4859
111007	서울특별시	도봉구	방학3동	21607	16948	8166	8073	450	9	96	8	0	2	11	10	4	7	16836	112	4659
111009	서울특별시	도봉구	창1동	18602	13777	6655	6508	384	4	78	2	1	3	8	5	4	6	13658	119	4825
111010	서울특별시	도봉구	창2동	23404	16727	8540	7400	451	11	141	1	3	1	13	13	3	8	16585	142	6677
111011	서울특별시	도봉구	창3동	10985	7650	3944	3353	184	4	46	3	2	5	10	9	2	4	7566	84	3335
111012	서울특별시	도봉구	창4동	21253	17111	8014	8416	437	7	83	7	3	5	8	9	1	5	16995	116	4142
111013	서울특별시	도봉구	창5동	19540	15097	6855	7630	376	12	77	6	1	3	11	9	4	6	14990	107	4443
111014	서울특별시	도봉구	도봉1동	18352	13240	6406	6228	313	6	113	4	4	4	11	17	4	3	13113	127	5112
111015	서울특별시	도봉구	도봉2동	22320	17297	8280	8320	424	9	87	3	10	0	9	14	2	7	17165	132	5023
111101	서울특별시	노원구	월계1동	17828	13465	6219	6612	349	9	82	2	2	3	15	24	1	2	13320	145	4363
111102	서울특별시	노원구	월계2동	19877	14638	7114	6837	389	7	77	4	0	6	16	36	4	7	14497	141	5239
111103	서울특별시	노원구	월계3동	22335	17155	7902	8425	471	5	100	2	3	6	13	42	5	7	16981	174	5180
111105	서울특별시	노원구	공릉1동	29596	22277	10865	10276	649	20	150	7	3	6	9	41	5	6	22037	240	7319
111106	서울특별시	노원구	공릉2동	29659	23233	10979	11104	745	15	117	2	1	8	15	46	0	5	23037	196	6426
111108	서울특별시	노원구	하계1동	19742	15139	6969	7444	416	5	88	1	2	9	8	6	4	7	14959	180	4603
111109	서울특별시	노원구	하계2동	18283	14823	7373	6783	432	10	57	4	2	0	9	24	0	5	14699	124	3460
111110	서울특별시	노원구	중계본동	16374	12794	6342	5852	399	7	58	1	1	3	7	4	0	4	12678	116	3580
111111	서울특별시	노원구	중계1동	18967	15205	7511	7061	437	7	42	0	2	5	5	12	3	6	15091	114	3762
111112	서울특별시	노원구	중계2·3동	27824	21176	10673	9530	609	9	124	1	2	9	14	10	7	7	20995	181	6648
111114	서울특별시	노원구	중계4동	15732	12152	5984	5617	333	7	66	5	4	5	12	11	2	4	12050	102	3580
111115	서울특별시	노원구	상계1동	29365	22044	10741	10288	644	7	131	8	1	5	21	15	4	3	21868	176	7321
111116	서울특별시	노원구	상계2동	17138	13045	6142	6317	362	13	73	3	1	1	7	11	3	5	12938	107	4093
111117	서울특별시	노원구	상계3·4동	20076	14469	6910	6944	335	5	105	4	1	2	16	18	7	7	14354	115	5607
111119	서울특별시	노원구	상계5동	19727	14726	7197	6905	356	9	91	4	2	4	14	22	3	4	14611	115	5001
111120	서울특별시	노원구	상계6·7동	25624	19973	9361	9648	642	11	90	6	2	8	14	20	5	4	19811	162	5651
111122	서울특별시	노원구	상계8동	16727	13162	6567	5974	435	8	37	7	0	2	8	9	2	1	13050	112	3565
111123	서울특별시	노원구	상계9동	16208	12864	6059	6223	375	6	62	0	2	4	9	5	4	4	12753	111	3344
111124	서울특별시	노원구	상계10동	14749	11715	5393	5804	333	9	57	2	6	4	3	7	2	2	11622	93	3034
111201	서울특별시	은평구	녹번동	28384	20496	10000	9556	609	13	115	7	2	0	19	11	3	5	20340	156	7888
111202	서울특별시	은평구	응암제1동	24561	18117	9099	8171	524	9	102	1	2	3	18	15	5	2	17951	166	6444
111203	서울특별시	은평구	응암제2동	19417	14241	7098	6522	437	4	60	5	1	4	10	6	3	2	14152	89	5176
111204	서울특별시	은평구	응암제3동	21195	15181	7997	6494	437	19	92	3	2	3	9	13	3	10	15082	99	6014
111205	서울특별시	은평구	증산동	12046	9313	4604	4301	252	10	48	2	1	4	9	10	1	0	9242	71	2733
111206	서울특별시	은평구	수색동	10156	7936	3598	3979	223	2	37	2	4	2	5	20	2	1	7875	61	2220
111207	서울특별시	은평구	신사제1동	23171	17634	9223	7614	471	13	112	6	2	6	17	13	5	5	17487	147	5537
111208	서울특별시	은평구	신사제2동	14785	10439	5163	4733	319	9	84	2	2	2	12	9	4	2	10341	98	4346
111209	서울특별시	은평구	갈현제2동	22881	16522	8597	7051	549	16	121	5	1	5	11	12	1	5	16374	148	6359
111210	서울특별시	은평구	구산동	25140	17850	9293	7698	506	21	118	7	5	4	5	22	4	10	17693	157	7290
111211	서울특별시	은평구	갈현제1동	17969	12831	6297	5865	398	9	99	8	0	2	21	4	6	4	12713	118	5138
111212	서울특별시	은평구	진관동	39815	31343	15442	14532	970	18	106	18	0	5	12	11	4	5	31123	220	8472
111213	서울특별시	은평구	불광제1동	30892	23542	11213	11204	748	17	125	8	3	5	13	22	4	8	23370	172	7350
111214	서울특별시	은평구	불광제2동	23879	17215	8589	7799	488	3	139	7	5	2	22	8	3	4	17069	146	6664
111215	서울특별시	은평구	대조동	21733	15102	7723	6582	520	12	80	6	1	5	13	22	2	5	14971	131	6631
111216	서울특별시	은평구	역촌동	36777	26560	14182	11038	854	25	153	6	5	6	34	23	12	4	26342	218	10217
111301	서울특별시	서대문구	충현동	14332	10374	4579	5271	335	10	56	2	1	2	7	15	2	3	10283	91	3958
111302	서울특별시	서대문구	천연동	13487	10601	4907	5222	301	6	37	1	2	4	10	12	0	3	10505	96	2886
111303	서울특별시	서대문구	북아현동	13201	10367	4730	5164	339	5	35	1	2	4	7	8	0	3	10298	69	2834
111306	서울특별시	서대문구	신촌동	14866	10186	4316	5177	450	13	44	4	2	1	5	7	1	5	10025	161	4680
111308	서울특별시	서대문구	연희동	25760	18534	8110	9295	752	10	90	11	2	3	14	24	6	3	18320	214	7226
111311	서울특별시	서대문구	홍제제1동	16962	12702	5968	6057	429	4	80	5	2	1	16	20	4	2	12588	114	4260
111312	서울특별시	서대문구	홍제제2동	12169	9847	4582	4824	296	4	51	1	1	3	2	18	1	2	9785	62	2322
111313	서울특별시	서대문구	홍제제3동	12718	9419	4721	4243	266	6	61	1	0	4	10	13	2	2	9329	90	3299
111315	서울특별시	서대문구	홍은제1동	17893	13661	6849	6192	373	6	81	7	2	2	8	24	4	4	13552	109	4232
111317	서울특별시	서대문구	홍은제2동	20473	14690	7340	6629	416	10	92	4	4	2	19	24	5	5	14550	140	5783
111318	서울특별시	서대문구	남가좌제1동	12944	10741	4982	5306	328	3	31	3	1	1	3	14	2	1	10675	66	2203
111319	서울특별시	서대문구	남가좌제2동	22063	16900	8158	7939	524	8	71	4	6	1	13	11	7	5	16747	153	5163
111320	서울특별시	서대문구	북가좌제1동	15075	12253	5719	6021	351	4	47	2	1	2	7	4	2	4	12164	89	2822
111321	서울특별시	서대문구	북가좌제2동	24157	17433	9031	7548	514	10	89	4	2	3	18	12	6	11	17248	185	6724
111401	서울특별시	마포구	공덕동	25890	18833	8282	9631	598	8	75	1	3	5	14	15	5	3	18640	193	7057
111402	서울특별시	마포구	아현동	19432	15528	6000	8881	465	11	44	0	2	4	4	9	1	1	15422	106	3904
111406	서울특별시	마포구	도화동	17835	14536	5842	8017	443	6	56	7	3	12	9	6	3	0	14404	132	3299
111407	서울특별시	마포구	용강동	16028	12799	5222	7015	376	4	48	3	1	4	10	10	3	1	12697	102	3229
111408	서울특별시	마포구	대흥동	11115	7998	3417	4136	281	2	37	1	3	4	8	6	2	3	7900	98	3117
111409	서울특별시	마포구	염리동	13121	10229	4445	5324	309	9	35	2	2	2	9	6	2	3	10148	81	2892
111410	서울특별시	마포구	신수동	16332	12632	5284	6745	402	6	52	6	0	2	8	12	2	6	12525	107	3700
111411	서울특별시	마포구	서강동	19925	15596	6603	8191	558	8	58	3	5	3	8	10	2	2	15451	145	4329
111412	서울특별시	마포구	서교동	19355	13774	6412	6447	614	18	66	6	1	4	7	13	2	1	13591	183	5581
111414	서울특별시	마포구	합정동	15631	12133	5808	5536	559	7	61	1	2	4	16	10	0	4	12008	125	3498
111415	서울특별시	마포구	망원1동	17069	12973	6625	5526	562	12	72	7	2	2	9	10	3	5	12835	138	4096
111416	서울특별시	마포구	망원2동	14842	11451	5998	4795	424	7	65	1	1	6	4	8	3	1	11313	138	3391
111417	서울특별시	마포구	연남동	13113	9854	4730	4471	442	15	65	6	1	4	6	9	2	1	9752	102	3259
111418	서울특별시	마포구	성산1동	14998	11182	5762	4703	502	9	65	10	3	1	6	9	3	3	11076	106	3816
111419	서울특별시	마포구	성산2동	28563	21482	10423	9929	757	21	97	6	2	3	22	18	5	4	21287	195	7081
111420	서울특별시	마포구	상암동	22139	17505	8544	8098	597	12	83	2	1	4	9	10	2	9	17371	134	4634
111501	서울특별시	양천구	목1동	21444	17429	6574	10253	406	5	51	1	3	2	12	3	2	2	17314	115	4015
111502	서울특별시	양천구	목2동	23538	18212	8723	8542	590	9	107	8	2	6	24	6	7	2	18026	186	5326
111503	서울특별시	양천구	목3동	16882	12567	5798	6150	375	4	74	3	3	2	13	7	5	2	12436	131	4315
111504	서울특별시	양천구	목4동	20139	15555	7415	7520	386	8	77	2	1	8	12	10	4	17	15460	95	4584
111505	서울특별시	양천구	목5동	28006	23149	7936	14478	526	4	44	6	0	12	7	8	2	2	23025	124	4857
111507	서울특별시	양천구	신월1동	16840	11958	6256	5140	302	4	113	0	3	5	11	11	1	3	11849	109	4882
111508	서울특별시	양천구	신월2동	14948	11163	5406	5286	276	9	68	9	0	0	7	4	2	3	11070	93	3785
111509	서울특별시	양천구	신월3동	11480	7645	3954	3321	183	5	76	3	1	2	14	9	1	2	7571	74	3835
111510	서울특별시	양천구	신월4동	14184	10829	5678	4665	285	5	74	4	2	2	6	4	5	9	10739	90	3355
111511	서울특별시	양천구	신월5동	11955	8884	4533	3969	207	13	74	3	1	2	8	8	2	1	8821	63	3071
111512	서울특별시	양천구	신월6동	13265	11212	5394	5413	280	7	49	1	2	2	4	6	1	1	11160	52	2053
111513	서울특별시	양천구	신월7동	16790	12474	6357	5577	313	6	79	2	2	5	3	13	2	2	12361	113	4316
111514	서울특별시	양천구	신정1동	15709	12977	5264	7224	320	4	39	2	1	3	12	5	1	4	12879	98	2732
111515	서울특별시	양천구	신정2동	16810	13851	6383	6942	340	6	45	1	4	3	11	4	3	5	13747	104	2959
111516	서울특별시	양천구	신정3동	33094	24895	12036	11802	646	12	130	7	4	6	18	10	4	5	24680	215	8199
111517	서울특별시	양천구	신정4동	25880	18902	9569	8410	545	11	135	6	2	8	14	13	6	7	18726	176	6978
111519	서울특별시	양천구	신정6동	18049	15184	5679	8990	380	6	28	0	0	1	3	2	0	2	15091	93	2865
111520	서울특별시	양천구	신정7동	20977	16594	6984	8903	417	11	101	1	4	5	19	3	4	4	16456	138	4383
111601	서울특별시	강서구	염창동	29526	23961	11265	11632	736	11	86	4	2	3	16	14	3	4	23776	185	5565
111602	서울특별시	강서구	등촌제1동	19438	14661	6866	6984	534	8	71	4	3	3	2	10	2	6	14493	168	4777
111603	서울특별시	강서구	등촌제2동	16057	12221	5507	6183	335	7	50	4	2	2	15	11	1	2	12119	102	3836
111604	서울특별시	강서구	등촌제3동	25992	20048	9382	9729	556	14	101	2	3	6	26	20	5	8	19852	196	5944
111605	서울특별시	강서구	화곡본동	25837	17596	9395	7214	541	12	163	9	3	9	13	33	5	3	17400	196	8241
111606	서울특별시	강서구	화곡제1동	39832	26571	13584	11630	754	22	217	10	6	6	22	18	11	8	26288	283	13261
111607	서울특별시	강서구	화곡제2동	14068	10039	5393	4149	291	8	85	3	2	2	9	10	5	1	9958	81	4029
111608	서울특별시	강서구	화곡제3동	19669	15626	7284	7651	442	6	89	1	4	2	7	8	2	5	15501	125	4043
111609	서울특별시	강서구	화곡제4동	17063	12274	6239	5457	337	9	102	1	0	3	10	5	5	3	12171	103	4789
111611	서울특별시	강서구	화곡제6동	21602	16269	7667	7796	490	9	111	2	3	2	17	12	0	6	16115	154	5333
111612	서울특별시	강서구	화곡제8동	20926	15403	8362	6261	409	20	133	9	2	3	13	10	7	10	15239	164	5523
111613	서울특별시	강서구	우장산동	29317	22576	10098	11548	606	12	91	1	3	3	22	12	6	8	22410	166	6741
111614	서울특별시	강서구	가양제1동	24579	18296	8058	9331	609	14	84	0	1	3	7	9	1	5	18122	174	6283
111615	서울특별시	강서구	가양제2동	13232	10204	4525	5198	290	1	64	1	3	6	6	7	3	4	10108	96	3028
111616	서울특별시	강서구	가양제3동	13394	10503	4927	5121	254	6	52	4	2	1	10	9	1	0	10387	116	2891
111617	서울특별시	강서구	발산제1동	28821	23090	12125	9930	622	18	107	7	4	13	19	18	3	7	22873	217	5731
111619	서울특별시	강서구	공항동	22335	15882	7716	7434	376	4	134	5	4	2	16	11	1	4	15707	175	6453
111620	서울특별시	강서구	방화제1동	33220	26085	12403	12602	677	14	146	6	1	4	16	22	3	6	25900	185	7135
111621	서울특별시	강서구	방화제2동	18795	13806	6339	6817	372	4	92	3	1	6	18	12	3	6	13673	133	4989
111622	서울특별시	강서구	방화제3동	19879	15544	7262	7623	378	6	83	6	2	5	13	9	2	4	15393	151	4335
111701	서울특별시	구로구	신도림동	27106	22069	9390	11783	613	10	71	7	4	5	15	8	6	8	21920	149	5037
111702	서울특별시	구로구	구로제1동	15849	12856	6296	6009	358	6	58	1	1	2	7	8	3	5	12754	102	2993
111703	서울특별시	구로구	구로제2동	18883	13020	6573	5931	266	7	87	2	1	5	5	19	2	7	12905	115	5863
111704	서울특별시	구로구	구로제3동	19216	14216	7618	5827	448	12	109	2	3	4	13	22	1	7	14066	150	5000
111705	서울특별시	구로구	구로제4동	15451	11026	5731	4760	276	7	90	8	4	5	12	12	5	6	10916	110	4425
111706	서울특별시	구로구	구로제5동	24344	18852	9231	8766	563	5	90	7	4	7	13	20	1	3	18710	142	5492
111709	서울특별시	구로구	가리봉동	7334	4745	2352	2155	90	2	63	0	0	2	7	3	3	1	4678	67	2589
111711	서울특별시	구로구	고척제1동	18492	14463	6721	7155	333	7	79	0	2	1	8	19	2	3	14330	133	4029
111712	서울특별시	구로구	고척제2동	20421	15142	7276	7218	369	12	97	4	2	8	16	28	2	7	15039	103	5279
111713	서울특별시	구로구	개봉제1동	26450	19781	9380	9535	484	12	123	4	3	5	15	24	6	6	19597	184	6669
111714	서울특별시	구로구	개봉제2동	24681	19420	9065	9507	536	9	123	3	0	4	17	13	4	5	19286	134	5261
111715	서울특별시	구로구	개봉제3동	16511	12332	6251	5572	294	8	71	0	2	2	12	13	2	2	12229	103	4179
111717	서울특별시	구로구	오류제1동	19653	14797	6986	7010	480	9	119	4	1	4	9	16	2	2	14642	155	4856
111718	서울특별시	구로구	오류제2동	27780	21159	10368	9830	596	15	115	5	1	9	15	18	4	5	20981	178	6621
111719	서울특별시	구로구	수궁동	18369	14083	6167	7298	364	10	94	1	1	6	10	9	2	3	13965	118	4286
111720	서울특별시	구로구	항동	11482	9439	4924	3960	401	5	56	2	0	1	6	8	2	1	9366	73	2043
111801	서울특별시	금천구	가산동	19972	13807	6986	6051	410	8	116	5	2	9	10	8	4	5	13614	193	6165
111802	서울특별시	금천구	독산제1동	34190	25121	12350	11487	788	16	162	11	5	3	19	23	7	9	24880	241	9069
111803	서울특별시	금천구	독산제2동	15643	10710	5642	4596	244	9	93	4	1	5	11	15	2	7	10629	81	4933
111804	서울특별시	금천구	독산제3동	20018	14146	7548	5963	345	7	102	3	2	0	16	15	3	5	14009	137	5872
111805	서울특별시	금천구	독산제4동	13236	9554	5062	4057	251	3	65	2	3	2	7	12	2	6	9472	82	3682
111807	서울특별시	금천구	시흥제1동	26284	18822	9189	8821	452	13	134	3	2	7	14	16	8	8	18667	155	7462
111808	서울특별시	금천구	시흥제2동	16498	13248	6519	6195	338	11	63	1	4	5	10	13	2	4	13165	83	3250
111809	서울특별시	금천구	시흥제3동	9360	7318	3623	3357	191	8	53	5	1	1	3	6	2	4	7254	64	2042
111810	서울특별시	금천구	시흥제4동	16384	11797	5946	5284	298	9	95	3	2	3	15	22	5	7	11689	108	4587
111811	서울특별시	금천구	시흥제5동	15975	11611	5926	5151	289	5	97	8	1	3	8	11	8	5	11512	99	4364
111901	서울특별시	영등포구	영등포본동	17314	13171	6096	6490	358	8	65	4	2	4	14	6	1	3	13051	120	4143
111902	서울특별시	영등포구	영등포동	21751	14833	6298	7660	552	10	74	7	4	6	12	12	2	7	14644	189	6918
111904	서울특별시	영등포구	여의동	25254	20059	5099	14372	394	3	60	7	1	9	17	4	1	2	19969	90	5195
111905	서울특별시	영등포구	당산제1동	18728	14733	6656	7378	443	7	70	10	1	1	17	11	3	5	14602	131	3995
111906	서울특별시	영등포구	당산제2동	28312	22410	8971	12363	722	12	84	6	1	5	16	5	1	5	22191	219	5902
111907	서울특별시	영등포구	도림동	14766	10801	5287	5035	259	9	74	2	3	1	12	8	0	6	10696	105	3965
111909	서울특별시	영등포구	문래동	24653	19936	8999	10077	620	6	66	1	4	2	16	10	0	5	19806	130	4717
111911	서울특별시	영등포구	양평제1동	15220	11850	5643	5604	402	5	64	5	2	1	8	5	2	2	11743	107	3370
111912	서울특별시	영등포구	양평제2동	16938	13439	6196	6555	483	4	57	1	1	1	7	13	2	1	13321	118	3499
111913	서울특별시	영등포구	신길제1동	14101	10096	4775	4795	310	10	72	3	1	3	6	10	5	2	9992	104	4005
111915	서울특별시	영등포구	신길제3동	12568	9339	4260	4646	241	6	65	1	0	6	8	7	1	1	9242	97	3229
111916	서울특별시	영등포구	신길제4동	10222	8014	3701	3974	223	7	28	2	0	2	6	6	2	1	7952	62	2208
111917	서울특별시	영등포구	신길제5동	9468	7474	3558	3603	200	4	33	1	1	1	2	9	0	2	7414	60	1994
111918	서울특별시	영등포구	신길제6동	14630	11062	4885	5660	300	9	59	4	6	3	9	17	5	2	10959	103	3568
111919	서울특별시	영등포구	신길제7동	13761	10831	4270	6104	285	6	43	2	0	1	9	10	2	4	10736	95	2930
111920	서울특별시	영등포구	대림제1동	12225	9212	4487	4359	187	7	58	1	2	3	6	20	5	0	9135	77	3013
111921	서울특별시	영등포구	대림제2동	10425	7575	3820	3433	165	7	51	2	2	0	6	7	0	0	7493	82	2850
111922	서울특별시	영등포구	대림제3동	17024	12535	5981	5994	317	5	99	1	2	2	9	16	4	10	12440	95	4489
112001	서울특별시	동작구	노량진제1동	23411	17417	7341	9334	427	6	104	4	4	7	10	12	2	4	17255	162	5994
112002	서울특별시	동작구	노량진제2동	11822	9113	4259	4383	236	11	58	0	1	3	7	24	2	2	8986	127	2709
112003	서울특별시	동작구	상도제1동	32877	25319	10705	13431	760	15	89	7	4	7	11	11	4	6	25050	269	7558
112004	서울특별시	동작구	상도제2동	21021	16161	6901	8600	419	6	64	1	1	6	8	3	4	4	16017	144	4860
112005	서울특별시	동작구	상도제3동	23080	17907	9400	7617	551	9	116	3	3	1	9	16	3	4	17732	175	5173
112006	서울특별시	동작구	상도제4동	20967	14781	7410	6655	414	11	95	5	0	6	15	11	5	7	14634	147	6186
112009	서울특별시	동작구	흑석동	24223	18761	6931	11061	480	9	75	3	3	3	5	14	3	6	18593	168	5462
112013	서울특별시	동작구	사당제1동	18046	13532	6438	6313	493	11	90	7	2	2	12	7	6	2	13383	149	4514
112014	서울특별시	동작구	사당제2동	22337	17962	7267	9938	482	4	84	1	4	2	11	9	1	4	17807	155	4375
112015	서울특별시	동작구	사당제3동	16772	12812	5205	7111	335	5	39	3	3	4	4	12	3	1	12725	87	3960
112016	서울특별시	동작구	사당제4동	12047	9328	4745	4132	263	11	69	3	2	6	10	4	4	2	9251	77	2719
112017	서울특별시	동작구	사당제5동	12032	9613	4596	4623	256	8	31	0	2	5	1	5	1	2	9530	83	2419
112018	서울특별시	동작구	대방동	26377	20003	9184	9898	555	21	101	8	1	7	8	21	8	7	19819	184	6374
112019	서울특별시	동작구	신대방제1동	17069	13275	5855	6854	360	5	73	2	1	5	7	10	0	3	13175	100	3794
112020	서울특별시	동작구	신대방제2동	16970	13274	6227	6391	454	3	60	3	0	3	4	6	3	4	13158	116	3696
112101	서울특별시	관악구	보라매동	19753	14476	7325	6341	469	9	123	3	1	6	7	7	6	4	14301	175	5277
112102	서울특별시	관악구	은천동	25731	19248	9855	8449	548	16	132	3	2	4	14	15	7	10	19055	193	6483
112103	서울특별시	관악구	성현동	22089	17247	8607	7834	473	12	103	9	0	7	10	10	5	6	17076	171	4842
112104	서울특별시	관악구	중앙동	13034	9683	4850	4194	408	7	73	2	0	2	5	10	3	3	9557	126	3351
112105	서울특별시	관악구	청림동	12110	9800	4701	4691	265	2	43	1	0	1	10	8	1	1	9724	76	2310
112106	서울특별시	관악구	행운동	24117	18383	8888	8313	720	22	122	8	0	4	16	12	3	5	18113	270	5734
112107	서울특별시	관악구	청룡동	28656	21507	10233	9913	796	23	136	5	3	5	15	18	9	5	21161	346	7149
112108	서울특별시	관악구	낙성대동	13626	10179	4797	4780	385	5	60	5	1	4	3	5	1	6	10052	127	3447
112109	서울특별시	관악구	인헌동	22643	17548	8768	7740	628	14	118	8	3	2	13	10	7	4	17315	233	5095
112110	서울특별시	관악구	남현동	14402	11003	5062	5367	370	12	50	3	3	4	12	7	1	3	10894	109	3399
112111	서울특별시	관악구	신림동	19991	13366	6454	5910	547	26	160	4	3	4	10	7	5	7	13137	229	6625
112112	서울특별시	관악구	신사동	18630	13038	6560	5710	408	13	108	3	1	4	7	15	5	5	12839	199	5592
112113	서울특별시	관악구	조원동	14833	10739	5240	4889	365	13	85	2	0	3	13	7	1	2	10620	119	4094
112114	서울특별시	관악구	미성동	24589	18216	8883	8518	489	9	124	5	1	5	12	22	5	6	18079	137	6373
112115	서울특별시	관악구	난곡동	21373	15064	7901	6359	431	13	146	3	1	6	20	17	5	7	14909	155	6309
112116	서울특별시	관악구	난향동	12021	9237	4797	4066	219	6	62	2	1	1	10	7	4	2	9177	60	2784
112117	서울특별시	관악구	서원동	18886	13035	6413	5775	467	18	124	3	2	4	7	11	2	5	12831	204	5851
112118	서울특별시	관악구	신원동	15558	11073	5466	4950	355	11	104	4	0	2	14	11	3	7	10927	146	4485
112119	서울특별시	관악구	서림동	17480	12109	5739	5599	428	13	102	3	4	3	5	15	2	1	11914	195	5371
112120	서울특별시	관악구	삼성동	18187	13930	7153	6145	331	14	101	4	1	6	14	13	7	5	13794	136	4257
112121	서울특별시	관악구	대학동	19574	13874	6601	6474	424	10	127	13	1	12	10	12	4	5	13693	181	5700
112201	서울특별시	서초구	서초1동	16946	13348	4212	8691	276	2	46	2	2	5	9	9	1	3	13258	90	3598
112202	서울특별시	서초구	서초2동	20005	15815	4352	10986	330	5	32	2	0	7	7	1	2	4	15728	87	4190
112203	서울특별시	서초구	서초3동	24856	19138	5863	12589	407	11	66	2	2	6	19	7	3	5	18980	158	5718
112204	서울특별시	서초구	서초4동	20971	16648	3525	12691	272	7	25	3	2	5	15	4	3	0	16552	96	4323
112205	서울특별시	서초구	잠원동	19301	15168	3836	10887	305	3	26	3	1	7	7	3	0	0	15078	90	4133
112206	서울특별시	서초구	반포본동	1316	933	292	613	19	0	2	0	0	0	2	0	0	3	931	2	383
112207	서울특별시	서초구	반포1동	25382	18995	5068	13375	337	7	67	2	0	13	10	5	1	2	18887	108	6387
112208	서울특별시	서초구	반포2동	10669	8894	1620	7083	124	0	17	1	0	6	3	2	1	1	8858	36	1775
112209	서울특별시	서초구	반포3동	16270	13281	2875	10098	178	4	19	0	1	5	4	4	0	1	13189	92	2989
112210	서울특별시	서초구	반포4동	13632	10782	2855	7593	224	3	23	1	3	2	3	4	2	1	10714	68	2850
112211	서울특별시	서초구	방배본동	15614	12507	3908	8231	233	2	28	2	1	8	4	1	0	1	12419	88	3107
112212	서울특별시	서초구	방배1동	13085	10288	3618	6263	260	2	40	1	0	0	8	3	1	1	10197	91	2797
112213	서울특별시	서초구	방배2동	14797	11713	4506	6761	266	6	50	0	1	2	4	7	2	3	11608	105	3084
112214	서울특별시	서초구	방배3동	13738	11053	3069	7679	198	7	19	2	2	6	5	1	2	1	10991	62	2685
112215	서울특별시	서초구	방배4동	17352	13603	4730	8317	337	11	53	3	0	4	10	6	2	4	13477	126	3749
112216	서울특별시	서초구	양재1동	29405	22516	8782	12870	531	10	96	5	2	7	26	9	4	6	22348	168	6889
112217	서울특별시	서초구	양재2동	17725	13598	6231	6710	380	8	97	3	0	4	13	7	4	2	13459	139	4127
112218	서울특별시	서초구	내곡동	13081	10498	3967	6118	249	4	42	3	0	4	16	5	3	1	10412	86	2583
112301	서울특별시	강남구	신사동	12872	9799	2285	7226	166	5	35	2	3	3	2	2	1	0	9730	69	3073
112302	서울특별시	강남구	논현1동	18465	11485	4302	6712	272	4	84	1	2	3	7	3	3	3	11396	89	6980
112303	서울특별시	강남구	논현2동	17087	11864	3531	7916	232	1	50	1	0	2	16	6	1	5	11761	103	5223
112304	서울특별시	강남구	압구정동	19599	15337	2115	12906	189	3	38	1	1	7	14	0	2	2	15278	59	4262
112306	서울특별시	강남구	청담동	19710	14597	3293	10930	223	4	41	1	1	6	11	1	3	2	14516	81	5113
112308	서울특별시	강남구	삼성1동	10296	8012	2021	5751	126	2	38	1	2	4	12	2	1	0	7960	52	2284
112309	서울특별시	강남구	삼성2동	23596	18023	5333	12113	367	7	73	2	4	8	5	7	3	3	17925	98	5573
112310	서울특별시	강남구	대치1동	17255	14639	2497	11802	228	3	23	1	0	3	7	6	2	2	14574	65	2616
112311	서울특별시	강남구	대치2동	24636	19902	4347	15035	325	4	46	3	2	7	14	6	3	1	19793	109	4734
112313	서울특별시	강남구	대치4동	15916	11473	4260	6789	227	4	62	1	1	3	6	10	3	7	11373	100	4443
112314	서울특별시	강남구	역삼1동	28166	17690	6592	10279	461	5	113	1	0	7	16	10	2	1	17487	203	10476
112315	서울특별시	강남구	역삼2동	27224	20723	6245	13858	399	8	62	4	6	5	11	4	3	4	20609	114	6501
112316	서울특별시	강남구	도곡1동	15710	12630	3579	8611	303	4	23	3	1	2	5	1	0	2	12534	96	3080
112317	서울특별시	강남구	도곡2동	22806	18193	3136	14645	267	7	23	2	1	2	16	2	1	2	18104	89	4613
112318	서울특별시	강남구	개포1동	5903	4851	1148	3572	76	2	21	0	0	3	4	0	0	1	4827	24	1052
112319	서울특별시	강남구	개포2동	19148	15895	3931	11501	311	5	32	0	0	2	10	7	2	2	15803	92	3253
112321	서울특별시	강남구	개포4동	17669	13764	4826	8426	301	7	75	2	0	6	11	6	2	11	13673	91	3905
112322	서울특별시	강남구	일원본동	16811	13760	4285	8990	337	5	33	2	2	4	10	9	2	5	13684	76	3051
112323	서울특별시	강남구	일원1동	12336	9401	3853	5110	234	6	72	2	2	11	9	8	2	2	9311	90	2935
112324	서울특별시	강남구	일원2동	14690	12025	4128	7477	251	6	51	2	1	3	10	7	2	8	11946	79	2665
112325	서울특별시	강남구	수서동	12656	9857	3708	5764	183	6	76	1	0	2	11	7	4	8	9770	87	2799
112326	서울특별시	강남구	세곡동	30139	23516	9916	12729	560	11	91	4	4	7	27	7	1	6	23363	153	6623
112401	서울특별시	송파구	풍납1동	10682	8144	3741	4081	180	5	49	0	5	8	9	5	4	4	8091	53	2538
112402	서울특별시	송파구	풍납2동	18768	14533	6064	7886	370	9	60	2	2	2	10	6	4	4	14419	114	4235
112403	서울특별시	송파구	거여1동	10579	8170	3810	4020	191	2	49	0	1	3	10	5	2	1	8094	76	2409
112404	서울특별시	송파구	거여2동	16376	13033	5877	6514	340	10	87	1	2	6	9	14	7	4	12871	162	3343
112405	서울특별시	송파구	마천1동	15054	10912	5279	5172	236	9	90	2	1	1	13	11	2	4	10820	92	4142
112406	서울특별시	송파구	마천2동	15986	11831	5933	5424	250	9	104	1	0	6	6	14	1	4	11752	79	4155
112407	서울특별시	송파구	방이1동	13248	10714	4563	5742	263	8	35	1	1	5	4	8	0	3	10633	81	2534
112408	서울특별시	송파구	방이2동	21133	15198	6660	7805	428	5	79	3	2	5	9	12	2	3	15013	185	5935
112409	서울특별시	송파구	오륜동	13729	11701	3006	8354	213	3	31	0	4	5	10	4	1	0	11631	70	2028
112410	서울특별시	송파구	오금동	28963	22229	9019	12395	506	9	105	1	1	8	11	11	1	4	22071	158	6734
112411	서울특별시	송파구	송파1동	20153	15598	7033	7822	463	12	72	2	3	2	11	13	4	1	15438	160	4555
112412	서울특별시	송파구	송파2동	15332	12542	4624	7467	282	5	39	1	0	3	10	9	2	1	12443	99	2790
112413	서울특별시	송파구	석촌동	25334	18421	8763	8827	472	8	130	3	2	3	13	4	3	5	18233	188	6913
112414	서울특별시	송파구	삼전동	24753	18020	8634	8543	486	10	117	5	5	2	12	6	9	5	17834	186	6733
112415	서울특별시	송파구	가락본동	20148	15230	6103	8456	370	11	98	0	3	6	20	8	2	1	15078	152	4918
112416	서울특별시	송파구	가락1동	20076	16881	5097	11272	331	3	34	0	0	5	13	3	1	2	16761	120	3195
112417	서울특별시	송파구	가락2동	23681	18739	7507	10497	482	5	67	2	2	10	6	13	1	4	18596	143	4942
112418	서울특별시	송파구	문정1동	17298	13906	5779	7599	307	5	69	1	1	3	10	5	0	3	13782	124	3392
112419	서울특별시	송파구	문정2동	21662	17130	5185	11335	389	6	48	2	3	2	10	5	2	1	16988	142	4532
112420	서울특별시	송파구	장지동	24026	19075	8726	9602	462	11	78	3	3	10	16	10	5	3	18929	146	4951
112421	서울특별시	송파구	잠실본동	22307	16068	7071	8298	408	7	105	1	3	1	10	7	2	2	15915	153	6239
112422	서울특별시	송파구	잠실2동	25386	21135	6214	14333	405	7	29	3	1	11	9	3	1	7	21023	112	4251
112423	서울특별시	송파구	잠실3동	23603	19321	4720	14062	357	6	38	1	2	12	14	5	0	2	19219	102	4282
112424	서울특별시	송파구	잠실4동	15170	12658	3753	8549	243	2	26	1	3	2	6	1	1	0	12587	71	2512
112426	서울특별시	송파구	잠실6동	13260	10834	2980	7563	197	1	15	0	3	0	3	1	1	3	10767	67	2426
112427	서울특별시	송파구	잠실7동	8389	7109	1633	5295	123	0	9	1	1	3	1	3	1	1	7071	38	1280
112428	서울특별시	송파구	위례동	24634	19856	8883	10179	511	8	85	7	3	5	10	23	0	8	19722	134	4778
112501	서울특별시	강동구	강일동	23947	18758	9643	8386	425	11	96	3	3	4	24	15	6	4	18620	138	5189
112503	서울특별시	강동구	명일제1동	20850	16627	6726	9239	413	10	75	2	0	5	9	8	3	8	16498	129	4223
112504	서울특별시	강동구	명일제2동	13894	11641	4424	6829	247	1	32	2	3	3	14	6	1	1	11563	78	2253
112505	서울특별시	강동구	고덕제1동	16884	13846	5666	7697	329	3	56	3	1	2	9	8	3	0	13777	69	3038
112506	서울특별시	강동구	고덕제2동	16115	12976	4789	7702	283	9	72	2	0	1	6	7	3	4	12878	98	3139
112507	서울특별시	강동구	암사제1동	25791	18302	8590	8904	450	7	149	3	1	5	17	19	4	4	18153	149	7489
112508	서울특별시	강동구	암사제2동	13975	11627	5190	5936	339	8	52	1	2	5	6	11	0	2	11552	75	2348
112509	서울특별시	강동구	암사제3동	14215	11831	4703	6727	277	5	31	1	1	1	16	4	2	1	11769	62	2384
112511	서울특별시	강동구	천호제1동	22067	16005	7536	7799	379	15	100	1	2	10	13	17	3	7	15882	123	6062
112512	서울특별시	강동구	천호제2동	26475	18744	8807	9106	456	7	148	4	2	4	19	21	3	3	18580	164	7731
112513	서울특별시	강동구	천호제3동	22232	16236	7235	8219	480	7	107	1	1	9	12	7	3	6	16087	149	5996
112515	서울특별시	강동구	성내제1동	15730	12374	5653	6198	350	9	59	1	2	0	5	7	2	2	12288	86	3356
112516	서울특별시	강동구	성내제2동	19146	13955	6391	6946	372	12	88	2	2	3	15	10	4	2	13847	108	5191
112517	서울특별시	강동구	성내제3동	18972	14466	6640	7180	390	6	112	2	1	2	10	8	0	3	14354	112	4506
112518	서울특별시	강동구	길동	35223	25470	11214	13184	602	16	166	5	2	8	25	22	6	7	25257	213	9753
112521	서울특별시	강동구	둔촌제1동	0	0	0	0	0	0	0	0	0	0	0	0	0	0	0	0	0
112521	서울특별시	강동구	둔촌제2동	19042	14551	6139	7795	391	10	58	3	2	4	12	9	4	1	14428	123	4491
112522	서울특별시	강동구	상일제1동	26247	21348	8207	12333	563	9	68	7	2	7	16	8	2	4	21226	122	4899
112523	서울특별시	강동구	상일제2동	7758	6258	3205	2746	188	2	34	2	1	2	3	5	3	3	6194	64	1500
260101	부산광역시	중구	중앙동	2498	1621	633	873	63	1	17	1	0	0	3	0	2	1	1594	27	877
260102	부산광역시	중구	동광동	2484	1735	639	1001	31	0	28	0	3	0	5	3	1	2	1713	22	749
260103	부산광역시	중구	대청동	5058	3459	1288	1997	79	2	46	2	0	0	2	4	2	1	3423	36	1599
260104	부산광역시	중구	보수동	8427	5803	2003	3528	125	1	87	1	1	0	8	3	3	1	5761	42	2624
260105	부산광역시	중구	부평동	4273	3082	919	2066	32	0	29	0	0	4	4	3	1	0	3058	24	1191
260106	부산광역시	중구	광복동	1079	838	260	551	6	0	10	0	0	0	1	0	0	0	828	10	241
260107	부산광역시	중구	남포동	844	579	148	406	13	1	8	0	0	0	0	0	0	0	576	3	265
260108	부산광역시	중구	영주제1동	3678	2322	876	1319	52	2	32	1	0	2	1	3	1	3	2292	30	1356
260109	부산광역시	중구	영주제2동	5727	4088	1483	2443	73	2	44	0	1	0	0	2	3	1	4052	36	1639
260201	부산광역시	서구	동대신제1동	4658	3529	1185	2174	83	1	45	1	0	3	3	3	2	3	3503	26	1129
260202	부산광역시	서구	동대신제2동	5503	3852	1251	2433	72	5	48	3	0	2	2	6	2	0	3824	28	1651
260203	부산광역시	서구	동대신제3동	6662	5026	1798	3012	111	4	45	1	1	2	4	3	1	0	4982	44	1636
260204	부산광역시	서구	서대신제1동	10496	7872	2912	4655	172	2	61	0	1	0	5	8	0	2	7818	54	2624
260205	부산광역시	서구	서대신제3동	5844	4365	1607	2586	94	4	31	2	0	2	5	5	0	1	4337	28	1479
260206	부산광역시	서구	서대신제4동	5966	4606	1765	2653	104	1	27	2	1	0	2	5	1	2	4563	43	1360
260207	부산광역시	서구	부민동	6115	4490	1669	2584	141	1	43	3	0	0	1	5	0	4	4451	39	1625
260208	부산광역시	서구	아미동	5541	3498	1157	2167	69	2	48	1	0	1	8	2	0	1	3456	42	2043
260209	부산광역시	서구	초장동	3518	2303	737	1454	44	1	37	0	0	1	1	4	1	2	2282	21	1215
260210	부산광역시	서구	충무동	8495	6002	1953	3813	131	2	43	0	3	0	3	3	1	2	5954	48	2493
260211	부산광역시	서구	남부민제1동	4240	2910	917	1871	53	0	27	1	0	1	4	4	2	1	2881	29	1330
260212	부산광역시	서구	남부민제2동	7419	4981	1757	2986	93	4	67	1	3	0	6	3	2	4	4926	55	2438
260214	부산광역시	서구	암남동	10040	6916	2509	4124	113	8	68	3	2	2	4	10	3	3	6849	67	3124
260301	부산광역시	동구	초량제1동	3914	2656	1031	1497	59	2	35	0	0	1	5	4	1	0	2635	21	1258
260302	부산광역시	동구	초량제2동	4923	3343	1101	2084	69	1	41	1	1	1	3	4	1	1	3308	35	1580
260303	부산광역시	동구	초량제3동	9862	7115	2826	3982	145	3	75	2	1	4	1	5	1	1	7046	69	2747
260304	부산광역시	동구	초량제6동	5028	3511	1165	2188	68	1	38	0	0	2	2	4	3	4	3475	36	1517
260306	부산광역시	동구	수정제1동	3783	2821	997	1699	53	3	42	0	0	1	2	3	1	3	2804	17	962
260307	부산광역시	동구	수정제2동	8619	6307	2242	3782	142	7	61	1	1	0	4	6	5	6	6257	50	2312
260309	부산광역시	동구	수정제4동	3194	2292	715	1487	35	0	20	2	1	1	5	5	0	1	2272	20	902
260310	부산광역시	동구	수정제5동	4489	3250	1140	1970	70	0	33	2	0	0	4	4	1	3	3227	23	1239
260311	부산광역시	동구	좌천동	9236	6607	2417	3897	132	1	72	1	2	3	4	10	3	2	6544	63	2629
260313	부산광역시	동구	범일제1동	9452	6393	2112	4018	96	4	66	4	0	8	8	8	4	5	6333	60	3059
260314	부산광역시	동구	범일제2동	6958	5091	1819	3084	70	0	53	0	0	1	10	1	1	3	5042	49	1867
260316	부산광역시	동구	범일제5동	3216	2370	793	1483	51	1	25	0	0	0	2	1	1	1	2358	12	846
260401	부산광역시	영도구	남항동	9294	6358	2333	3838	75	4	45	2	2	1	2	8	1	3	6314	44	2936
260402	부산광역시	영도구	영선제1동	3347	2337	951	1310	29	3	16	1	1	1	3	4	2	1	2322	15	1010
260403	부산광역시	영도구	영선제2동	8228	6248	2473	3573	101	4	38	3	0	1	3	9	1	0	6206	42	1980
260404	부산광역시	영도구	신선동	6493	4005	1606	2219	73	1	44	0	1	1	9	7	2	3	3966	39	2488
260405	부산광역시	영도구	봉래제1동	6042	4424	1705	2563	84	0	31	1	2	0	2	6	2	1	4397	27	1618
260406	부산광역시	영도구	봉래제2동	6188	4330	1849	2278	100	5	45	1	0	0	0	13	0	2	4293	37	1858
260407	부산광역시	영도구	청학제1동	5104	3433	1434	1847	59	1	44	3	0	0	2	5	3	0	3398	35	1671
260408	부산광역시	영도구	청학제2동	13381	9021	3730	4892	186	4	90	3	0	1	7	23	5	4	8945	76	4360
260409	부산광역시	영도구	동삼제1동	21770	15116	6440	8037	318	5	140	5	6	2	13	26	4	8	15004	112	6654
260410	부산광역시	영도구	동삼제2동	3021	2164	838	1224	43	0	21	1	0	0	2	2	1	1	2133	31	857
260411	부산광역시	영도구	동삼제3동	8971	6205	2490	3411	117	2	77	3	3	5	7	11	4	6	6136	69	2766
260501	부산광역시	부산진구	부전제1동	14743	10178	3514	6156	244	7	121	2	1	2	10	2	2	5	10066	112	4565
260502	부산광역시	부산진구	부전제2동	8930	6165	2180	3698	121	2	72	4	0	0	8	2	0	3	6090	75	2765
260504	부산광역시	부산진구	연지동	16003	12249	4437	7354	233	6	92	0	2	6	8	13	5	9	12165	84	3754
260505	부산광역시	부산진구	초읍동	17835	13249	4507	8256	235	6	123	1	2	3	11	25	6	4	13179	70	4586
260506	부산광역시	부산진구	양정제1동	16664	12649	4719	7404	269	1	111	1	0	5	14	18	1	4	12547	102	4015
260507	부산광역시	부산진구	양정제2동	8728	5424	1996	3119	133	2	73	2	1	3	9	11	3	3	5355	69	3304
260508	부산광역시	부산진구	전포제1동	17565	12014	4474	6836	350	9	162	5	0	4	14	15	2	2	11873	141	5551
260509	부산광역시	부산진구	전포제2동	16196	11133	3998	6594	228	8	144	5	5	2	17	13	3	7	11024	109	5063
260511	부산광역시	부산진구	부암제1동	17094	12192	4821	6908	232	3	103	2	0	0	3	12	1	2	12087	105	4902
260512	부산광역시	부산진구	부암제3동	14084	10638	4489	5753	179	5	87	4	1	0	9	30	6	3	10566	72	3446
260513	부산광역시	부산진구	당감제1동	18618	13613	5507	7565	257	7	104	3	3	10	13	22	5	6	13502	111	5005
260514	부산광역시	부산진구	당감제2동	8995	7216	2778	4113	182	3	59	2	1	0	7	13	2	5	7165	51	1779
260516	부산광역시	부산진구	당감제4동	9469	6964	3051	3611	145	4	64	1	2	2	8	20	1	1	6910	54	2505
260517	부산광역시	부산진구	가야제1동	15917	10954	3988	6406	253	8	120	4	0	1	10	16	3	11	10820	134	4963
260518	부산광역시	부산진구	가야제2동	13285	9893	3490	6003	198	9	90	1	1	2	6	12	3	3	9818	75	3392
260520	부산광역시	부산진구	개금제1동	13753	9731	3686	5500	275	4	117	6	3	0	8	16	4	5	9624	107	4022
260521	부산광역시	부산진구	개금제2동	9121	6777	2507	3954	157	6	65	1	0	3	6	10	5	0	6714	63	2344
260522	부산광역시	부산진구	개금제3동	22476	16787	6468	9574	362	14	154	4	2	4	19	34	1	4	16640	147	5689
260523	부산광역시	부산진구	범천제1동	10175	6728	2466	3942	152	5	75	1	1	2	5	10	2	1	6662	66	3447
260524	부산광역시	부산진구	범천제2동	15754	10972	4092	6360	234	10	141	2	0	1	14	10	4	5	10873	99	4782
260601	부산광역시	동래구	수민동	23627	17719	6400	10529	416	8	166	4	2	5	23	25	4	10	17592	127	5908
260602	부산광역시	동래구	복산동	8661	6610	2038	4313	128	6	58	2	0	0	7	4	4	3	6563	47	2051
260603	부산광역시	동래구	명륜동	17880	13971	5076	8369	291	2	96	1	3	3	7	16	2	1	13867	104	3909
260605	부산광역시	동래구	온천제1동	16981	11807	4056	7182	287	4	127	0	1	2	8	16	1	1	11685	122	5174
260606	부산광역시	동래구	온천제2동	16123	12690	4087	8109	276	6	94	1	2	6	6	16	0	5	12608	82	3433
260607	부산광역시	동래구	온천제3동	26928	18481	6510	11109	409	5	201	4	5	6	15	36	0	7	18307	174	8447
260608	부산광역시	동래구	사직제1동	9046	7052	2461	4264	169	1	76	2	1	1	3	3	1	2	6984	68	1994
260609	부산광역시	동래구	사직제2동	19045	15058	6173	8320	338	7	96	3	0	1	9	17	0	7	14971	87	3987
260610	부산광역시	동래구	사직제3동	13652	10355	3783	6114	235	2	95	3	2	2	9	14	5	4	10268	87	3297
260611	부산광역시	동래구	안락제1동	12609	9496	3217	5881	187	7	98	2	1	5	11	14	4	6	9433	63	3113
260612	부산광역시	동래구	안락제2동	20360	15601	5618	9246	400	6	134	4	4	7	19	20	3	4	15465	136	4759
260613	부산광역시	동래구	명장제1동	11482	8744	2987	5374	169	5	93	1	2	2	11	16	3	4	8667	77	2738
260614	부산광역시	동래구	명장제2동	11655	8483	2906	5238	142	4	83	5	2	3	7	17	2	5	8414	69	3172
260701	부산광역시	남구	대연제1동	13558	9343	3366	5528	206	4	88	2	1	3	18	5	5	7	9233	110	4215
260703	부산광역시	남구	대연제3동	23510	17257	6634	9872	427	15	91	3	1	5	10	18	1	5	17082	175	6253
260704	부산광역시	남구	대연제4동	9958	7553	2812	4424	157	4	67	2	1	0	9	12	1	2	7491	62	2405
260705	부산광역시	남구	대연제5동	13463	9889	3662	5759	241	6	76	4	0	3	9	13	1	3	9777	112	3574
260706	부산광역시	남구	대연제6동	12534	10090	3789	5932	217	3	55	0	1	2	11	9	0	2	10021	69	2444
260707	부산광역시	남구	용호제1동	29227	21710	6796	14144	403	1	139	3	5	7	15	22	8	5	21548	162	7517
260708	부산광역시	남구	용호제2동	12432	9407	3319	5751	165	5	82	2	1	3	7	13	2	3	9353	54	3025
260709	부산광역시	남구	용호제3동	13793	10902	4018	6529	177	0	74	3	0	3	5	13	4	5	10831	71	2891
260710	부산광역시	남구	용호제4동	7749	5913	2413	3260	116	2	64	1	3	1	11	6	0	0	5877	36	1836
260711	부산광역시	남구	용당동	6250	4706	1858	2670	87	1	34	2	0	2	6	15	1	0	4676	30	1544
260712	부산광역시	남구	감만제1동	10533	7472	2856	4249	181	1	88	3	0	3	6	21	3	3	7414	58	3061
260713	부산광역시	남구	감만제2동	6128	4516	1701	2612	84	2	50	2	1	3	2	17	2	1	4477	39	1612
260716	부산광역시	남구	문현제1동	11101	8105	3050	4712	153	0	88	2	2	3	8	17	1	2	8038	67	2996
260717	부산광역시	남구	문현제2동	6845	4618	1637	2750	113	2	53	2	0	2	1	4	1	1	4566	52	2227
260718	부산광역시	남구	문현제3동	11800	8844	3279	5202	196	3	78	5	1	2	8	9	2	3	8788	56	2956
260719	부산광역시	남구	문현제4동	7158	5237	1832	3218	84	0	49	0	1	0	4	12	0	2	5202	35	1921
260720	부산광역시	남구	우암동	9952	7258	2611	4337	125	2	77	2	0	0	16	19	9	3	7201	57	2694
260801	부산광역시	북구	구포제1동	14140	10209	3720	5991	202	8	135	4	3	2	5	13	6	13	10102	107	3931
260802	부산광역시	북구	구포제2동	20189	14264	5441	8154	294	8	178	6	7	4	15	13	4	12	14136	128	5925
260803	부산광역시	북구	구포제3동	16071	10675	4243	5885	228	8	167	2	2	3	11	15	1	5	10570	105	5396
260808	부산광역시	북구	덕천제1동	9611	6815	2417	4065	156	0	75	6	0	5	10	8	6	5	6753	62	2796
260809	부산광역시	북구	덕천제2동	10939	7827	2838	4580	166	5	112	2	1	0	5	14	4	8	7735	92	3112
260810	부산광역시	북구	덕천제3동	9175	6395	2363	3719	143	1	76	4	2	0	11	11	3	2	6335	60	2780
260811	부산광역시	북구	만덕제1동	13181	10256	4110	5702	219	8	105	3	1	1	14	4	3	3	10173	83	2925
260812	부산광역시	북구	만덕제2동	20377	15204	6163	8403	320	3	158	5	0	8	17	14	2	3	15096	108	5173
260813	부산광역시	북구	만덕제3동	15068	11494	4370	6652	235	3	111	5	0	5	9	8	3	5	11406	88	3574
260814	부산광역시	북구	금곡동	30647	22881	9223	12567	505	7	257	7	5	9	30	25	6	21	22662	219	7766
260815	부산광역시	북구	화명제1동	30243	23820	9211	13649	558	6	178	3	3	4	23	15	0	10	23660	160	6423
260816	부산광역시	북구	화명제2동	13474	10103	4085	5537	233	5	106	4	2	2	12	17	3	4	10010	93	3371
260817	부산광역시	북구	화명제3동	23359	19005	7769	10442	479	12	119	3	4	1	20	19	3	11	18882	123	4354
260901	부산광역시	해운대구	우제1동	16933	12003	3722	7824	194	6	140	3	0	4	5	13	3	3	11917	86	4930
260902	부산광역시	해운대구	우제2동	22550	17594	5462	11613	283	5	85	2	0	3	20	11	2	2	17488	106	4956
260903	부산광역시	해운대구	중제1동	20562	15117	4806	9764	288	5	115	3	5	3	12	7	0	4	15012	105	5445
260904	부산광역시	해운대구	중제2동	12788	9397	3185	5893	178	4	60	1	1	1	7	6	2	4	9342	55	3391
260905	부산광역시	해운대구	좌제1동	15220	11824	4469	6890	274	3	78	4	1	2	2	15	0	0	11738	86	3396
260906	부산광역시	해운대구	좌제2동	24701	18294	6854	10742	385	9	132	4	2	7	5	16	6	3	18165	129	6407
260907	부산광역시	해운대구	좌제3동	12990	10099	3835	5895	219	3	67	2	0	6	10	9	0	3	10049	50	2891
260908	부산광역시	해운대구	좌제4동	18226	14535	5668	8356	317	5	79	4	2	2	5	10	2	3	14453	82	3691
260909	부산광역시	해운대구	송정동	8500	6060	2148	3653	124	1	65	0	2	1	10	6	2	4	6016	44	2440
260910	부산광역시	해운대구	반여제1동	26142	20135	7940	11446	402	11	142	3	1	2	20	13	4	14	19998	137	6007
260911	부산광역시	해운대구	반여제2동	11120	7519	2783	4403	141	8	88	4	1	3	10	10	5	3	7459	60	3601
260912	부산광역시	해운대구	반여제3동	7543	5072	1871	2946	118	6	65	0	0	0	7	12	1	0	5026	46	2471
260913	부산광역시	해운대구	반여제4동	12366	9381	3708	5286	211	2	78	3	0	1	8	12	2	5	9316	65	2985
260914	부산광역시	해운대구	반송제1동	12270	8275	3041	4800	140	8	125	5	1	3	19	24	6	8	8180	95	3995
260915	부산광역시	해운대구	반송제2동	19690	13884	5133	8066	260	7	185	5	2	4	19	50	3	9	13743	141	5806
260917	부산광역시	해운대구	재송제1동	26802	20205	7211	12287	402	12	124	5	3	3	18	14	4	6	20089	116	6597
260918	부산광역시	해운대구	재송제2동	19446	13283	5187	7549	258	8	142	5	2	5	13	13	1	7	13190	93	6163
260919	부산광역시	해운대구	우제3동	21447	16991	3957	12658	212	1	58	1	2	4	12	6	1	3	16915	76	4456
261001	부산광역시	기장군	기장읍	41832	28328	9820	17278	560	10	334	12	5	6	37	34	6	4	28106	222	13504
261002	부산광역시	기장군	장안읍	7647	5804	1748	3811	109	3	72	1	0	1	6	13	3	1	5768	36	1843
261003	부산광역시	기장군	일광면	18904	13964	5175	8256	284	7	129	0	3	2	5	13	1	5	13880	84	4940
261004	부산광역시	기장군	정관읍	54393	38545	18380	18460	872	16	437	8	2	9	21	44	3	19	38271	274	15848
261005	부산광역시	기장군	철마면	6552	4991	1763	3029	96	3	52	0	0	1	4	9	3	5	4965	26	1561
261101	부산광역시	사하구	괴정제1동	16237	11877	4349	7046	228	6	88	2	3	3	13	19	4	4	11765	112	4360
261102	부산광역시	사하구	괴정제2동	10700	7386	2739	4337	151	4	83	3	0	2	5	8	2	2	7336	50	3314
261103	부산광역시	사하구	괴정제3동	11201	8193	3071	4799	156	1	75	1	0	2	7	13	5	4	8134	59	3008
261104	부산광역시	사하구	괴정제4동	9834	7151	2652	4177	147	6	81	0	2	2	7	11	2	4	7091	60	2683
261105	부산광역시	사하구	당리동	20972	15377	5852	8872	317	6	164	1	5	4	15	16	4	2	15258	119	5595
261106	부산광역시	사하구	하단제1동	17947	13090	5101	7402	271	8	146	3	4	5	4	16	6	6	12972	118	4857
261107	부산광역시	사하구	하단제2동	19418	13398	5073	7692	305	6	140	4	3	3	6	19	3	5	13259	139	6020
261108	부산광역시	사하구	신평제1동	14284	9863	3982	5408	211	3	120	3	1	1	12	11	6	5	9763	100	4421
261109	부산광역시	사하구	신평제2동	13903	10214	4268	5445	262	5	123	2	1	3	7	8	1	1	10126	88	3689
261110	부산광역시	사하구	장림제1동	9370	6559	2939	3320	144	4	75	2	0	1	5	6	0	7	6503	56	2811
261111	부산광역시	사하구	장림제2동	21161	14164	5820	7673	308	7	175	3	2	3	17	20	3	7	14038	126	6997
261112	부산광역시	사하구	다대제1동	29830	21075	8722	11357	490	5	252	7	3	5	14	31	6	6	20898	177	8755
261113	부산광역시	사하구	다대제2동	22096	16098	6325	9075	312	7	178	4	2	4	15	25	6	11	15964	134	5998
261114	부산광역시	사하구	구평동	9942	7038	3038	3672	172	4	89	1	0	0	3	6	0	3	6988	50	2904
261115	부산광역시	사하구	감천제1동	15284	10721	4078	6165	232	4	116	1	3	0	11	9	3	9	10631	90	4563
261116	부산광역시	사하구	감천제2동	4852	3059	1076	1831	48	2	56	1	0	1	1	4	4	3	3027	32	1793
261201	부산광역시	금정구	서제1동	4650	3135	1039	1962	41	1	46	0	2	0	4	6	3	3	3107	28	1515
261202	부산광역시	금정구	서제2동	7890	5588	1841	3513	96	4	61	4	1	1	9	5	4	2	5541	47	2302
261203	부산광역시	금정구	서제3동	9563	6605	2196	4113	131	6	84	0	4	3	9	6	5	1	6558	47	2958
261206	부산광역시	금정구	부곡제1동	7627	5655	1920	3507	95	2	54	1	0	2	12	12	1	1	5607	48	1972
261207	부산광역시	금정구	부곡제2동	14049	10665	3836	6344	255	8	96	4	1	3	8	12	5	5	10577	88	3384
261208	부산광역시	금정구	부곡제3동	13291	10385	3802	6156	241	4	74	2	3	0	6	14	4	1	10307	78	2906
261209	부산광역시	금정구	부곡제4동	10639	7869	2590	4879	180	7	92	1	0	2	10	10	1	4	7776	93	2770
261210	부산광역시	금정구	장전제1동	13900	10457	3651	6166	323	5	82	3	4	4	9	33	0	3	10283	174	3443
261211	부산광역시	금정구	장전제2동	19050	14182	4992	8602	323	3	87	4	2	3	21	17	3	3	14060	122	4868
261213	부산광역시	금정구	선두구동	2358	1887	576	1235	34	0	20	1	1	0	1	0	0	2	1870	17	471
261214	부산광역시	금정구	청룡노포동	8221	6353	2074	4063	100	5	42	0	0	2	4	12	1	3	6306	47	1868
261215	부산광역시	금정구	남산동	22935	16469	5611	10089	337	17	194	4	5	2	20	28	5	6	16318	151	6466
261216	부산광역시	금정구	구서제1동	15708	12238	4370	7376	279	7	77	0	0	2	13	10	0	5	12139	99	3470
261217	부산광역시	금정구	구서제2동	25258	19676	6761	12124	442	10	133	7	1	12	9	21	6	9	19535	141	5582
261218	부산광역시	금정구	금성동	841	689	240	405	22	1	6	0	0	1	0	6	1	1	683	6	152
261219	부산광역시	금정구	금사회동동	6942	4956	1618	3119	98	7	53	2	1	2	3	5	4	0	4912	44	1986
261301	부산광역시	강서구	대저1동	5400	3876	1291	2441	58	1	44	0	1	0	2	2	1	1	3842	34	1524
261302	부산광역시	강서구	대저2동	5511	3998	1385	2471	55	4	43	0	0	2	3	3	1	1	3968	30	1513
261303	부산광역시	강서구	강동동	3573	2621	825	1708	39	0	22	0	1	2	4	2	1	1	2605	16	952
261305	부산광역시	강서구	가락동	2012	1528	516	949	26	1	24	0	0	1	1	0	0	0	1518	10	484
261306	부산광역시	강서구	녹산동	23323	14623	6360	7542	339	10	246	2	2	4	16	15	6	1	14543	80	8700
261307	부산광역시	강서구	가덕도동	3097	2204	781	1347	22	2	32	0	1	0	2	0	0	3	2190	14	893
261312	부산광역시	강서구	명지1동	34816	25627	11455	13081	636	3	245	2	3	1	6	23	6	5	25466	161	9189
261313	부산광역시	강서구	명지2동	23151	18722	8567	9459	415	2	150	2	4	2	6	9	1	4	18621	101	4429
261401	부산광역시	연제구	거제제1동	20354	16006	5900	9435	415	7	90	1	1	2	3	14	1	4	15873	133	4348
261402	부산광역시	연제구	거제제2동	9057	7247	2603	4382	142	5	48	0	1	1	3	9	0	2	7196	51	1810
261403	부산광역시	연제구	거제제3동	8332	6424	2175	3982	129	2	61	0	0	1	7	11	3	3	6374	50	1908
261404	부산광역시	연제구	거제제4동	7975	6034	2182	3597	125	3	67	1	0	2	9	4	3	1	5994	40	1941
261405	부산광역시	연제구	연산제1동	13746	10529	3796	6355	206	4	72	1	1	1	7	16	2	0	10461	68	3217
261406	부산광역시	연제구	연산제2동	16619	12663	4640	7523	289	2	85	1	1	1	11	14	0	6	12573	90	3956
261407	부산광역시	연제구	연산제3동	8248	6098	2175	3656	135	0	60	0	3	5	8	11	1	3	6057	41	2150
261408	부산광역시	연제구	연산제4동	13935	10161	3546	6179	218	6	99	0	2	2	7	13	1	3	10076	85	3774
261409	부산광역시	연제구	연산제5동	13930	9431	3525	5400	235	8	118	1	1	4	7	9	0	3	9311	120	4499
261410	부산광역시	연제구	연산제6동	13093	9249	3253	5553	193	7	114	6	2	1	12	20	2	7	9170	79	3844
261412	부산광역시	연제구	연산제8동	11333	8608	3289	4965	182	7	72	0	1	2	9	21	0	1	8549	59	2725
261413	부산광역시	연제구	연산제9동	25919	18929	6799	11448	349	9	131	3	1	8	15	37	3	3	18806	123	6990
261501	부산광역시	수영구	남천제1동	10426	7630	2637	4671	170	2	66	1	1	4	4	10	2	2	7570	60	2796
261502	부산광역시	수영구	남천제2동	10324	8205	2451	5539	114	3	40	1	0	3	7	7	0	1	8166	39	2119
261503	부산광역시	수영구	수영동	13302	10135	3266	6492	191	4	85	2	2	2	12	7	0	5	10068	67	3167
261504	부산광역시	수영구	망미제1동	21582	15996	5456	9914	329	7	119	2	2	3	19	20	6	4	15881	115	5586
261505	부산광역시	수영구	망미제2동	8494	6291	2240	3799	142	0	52	0	1	3	6	3	1	5	6252	39	2203
261506	부산광역시	수영구	광안제1동	20963	14492	5426	8328	384	12	158	3	3	4	12	10	2	8	14350	142	6471
261507	부산광역시	수영구	광안제2동	15095	10759	3837	6418	293	3	93	3	3	1	5	5	1	1	10663	96	4336
261508	부산광역시	수영구	광안제3동	8291	5696	1939	3453	149	2	56	1	0	2	5	2	3	1	5613	83	2595
261509	부산광역시	수영구	광안제4동	10536	7706	2868	4495	187	1	65	2	1	1	6	9	1	1	7637	69	2830
261510	부산광역시	수영구	민락동	21236	15323	5091	9728	272	7	106	0	3	2	17	11	5	3	15245	78	5913
261601	부산광역시	사상구	삼락동	5017	3500	1389	1954	67	3	43	0	0	1	5	3	1	3	3469	31	1517
261602	부산광역시	사상구	모라제1동	23108	16712	6359	9539	358	5	193	11	4	7	19	34	6	10	16545	167	6396
261604	부산광역시	사상구	모라제3동	9433	6674	2598	3776	111	1	72	3	3	0	8	12	5	4	6593	81	2759
261605	부산광역시	사상구	덕포제1동	8211	6031	2318	3455	115	5	62	3	2	1	3	3	7	5	5979	52	2180
261606	부산광역시	사상구	덕포제2동	10587	7721	3172	4191	180	5	76	0	2	1	6	12	2	6	7653	68	2866
261607	부산광역시	사상구	괘법동	18817	12721	4940	7080	290	11	203	0	4	2	11	14	5	4	12564	157	6096
261608	부산광역시	사상구	감전동	10838	7226	2661	4236	133	1	95	4	0	1	1	10	4	4	7150	76	3612
261610	부산광역시	사상구	주례제1동	12002	8762	3367	4967	218	2	94	2	0	2	12	6	0	2	8672	90	3240
261611	부산광역시	사상구	주례제2동	17612	12292	4791	6882	292	10	135	2	3	2	11	13	2	6	12149	143	5320
261612	부산광역시	사상구	주례제3동	10841	8118	3060	4705	159	4	93	5	1	1	7	11	1	5	8052	66	2723
261613	부산광역시	사상구	학장동	22404	16165	6532	8870	369	9	183	7	3	3	18	19	3	13	16029	136	6239
261614	부산광역시	사상구	엄궁동	21308	15760	6461	8525	377	11	190	3	2	2	4	18	5	19	15617	143	5548
270101	대구광역시	중구	동인동	6482	4589	891	3498	87	6	47	3	2	2	9	1	0	1	4547	42	1893
270103	대구광역시	중구	삼덕동	5201	3701	887	2630	88	2	34	3	1	0	11	4	0	2	3662	39	1500
270104	대구광역시	중구	성내1동	4025	2662	597	1927	63	3	29	0	1	0	11	0	0	3	2634	28	1363
270105	대구광역시	중구	성내2동	3982	2819	563	2132	46	1	31	1	0	3	8	1	0	1	2787	32	1163
270106	대구광역시	중구	성내3동	3742	2923	595	2238	39	2	18	0	0	2	5	0	0	0	2899	24	819
270107	대구광역시	중구	대신동	6322	5038	976	3905	75	3	24	0	0	6	4	0	1	3	4997	41	1284
270108	대구광역시	중구	남산1동	3747	2742	542	2073	58	1	22	1	1	2	8	0	1	0	2709	33	1005
270109	대구광역시	중구	남산2동	4925	3832	827	2854	91	1	18	3	1	0	9	2	0	3	3809	23	1093
270110	대구광역시	중구	남산3동	5003	3844	905	2809	57	3	24	0	0	1	8	4	0	4	3815	29	1159
270111	대구광역시	중구	남산4동	8727	6983	1378	5289	135	10	58	4	1	0	13	4	2	6	6900	83	1744
270112	대구광역시	중구	대봉1동	5149	4046	698	3215	68	3	21	1	1	1	6	1	2	1	4018	28	1103
270113	대구광역시	중구	대봉2동	1802	1430	287	1090	30	2	6	2	0	0	3	1	0	0	1421	9	372
270201	대구광역시	동구	신암1동	7498	5755	1001	4522	100	2	42	1	0	3	14	3	5	3	5696	59	1743
270202	대구광역시	동구	신암2동	8446	6867	1418	5194	127	1	54	1	0	2	11	4	3	2	6817	50	1579
270203	대구광역시	동구	신암3동	8714	6688	1362	5084	116	1	49	2	1	3	5	1	1	0	6625	63	2026
270204	대구광역시	동구	신암4동	9306	6524	1170	5080	125	3	58	0	0	2	10	5	2	2	6457	67	2782
270205	대구광역시	동구	신암5동	6912	5644	1092	4326	110	5	46	2	2	3	8	1	4	1	5600	44	1268
270206	대구광역시	동구	신천1·2동	10402	8218	1695	6197	136	4	71	1	2	5	18	4	2	1	8136	82	2184
270207	대구광역시	동구	신천3동	9264	7356	1570	5506	135	4	60	0	1	2	9	4	1	1	7293	63	1908
270208	대구광역시	동구	신천4동	6685	4900	979	3735	103	2	35	3	1	5	4	2	1	1	4871	29	1785
270209	대구광역시	동구	효목1동	10739	7877	1393	6195	94	3	79	0	0	2	31	6	3	2	7808	69	2862
270210	대구광역시	동구	효목2동	10952	8303	1650	6353	137	4	73	0	1	6	13	3	3	1	8244	59	2649
270211	대구광역시	동구	도평동	3546	2791	528	2162	38	1	31	0	0	1	5	1	0	4	2771	20	755
270212	대구광역시	동구	불로·봉무동	15409	12077	2628	9017	235	4	77	2	3	1	15	5	2	1	11990	87	3332
270213	대구광역시	동구	지저동	11998	9088	1701	7028	140	3	88	1	0	0	27	11	5	6	9010	78	2910
270214	대구광역시	동구	동촌동	13113	9571	1868	7316	168	5	89	0	1	1	33	3	3	6	9493	78	3542
270215	대구광역시	동구	방촌동	15153	11860	2180	9252	199	10	92	1	2	2	18	5	5	5	11771	89	3293
270216	대구광역시	동구	해안동	13337	9969	1847	7730	150	7	113	1	2	3	7	8	5	1	9874	95	3368
270217	대구광역시	동구	안심1동	32247	24078	5717	17325	497	8	223	5	2	9	40	25	7	9	23867	211	8169
270218	대구광역시	동구	안심2동	9087	6958	1420	5250	115	2	67	0	0	0	15	6	3	3	6881	77	2129
270220	대구광역시	동구	공산동	17320	13364	2909	9986	233	4	102	3	1	3	23	8	2	4	13278	86	3956
270221	대구광역시	동구	안심3동	16721	13331	3847	8856	332	7	97	1	10	0	37	9	3	5	13204	127	3390
270222	대구광역시	동구	안심4동	20035	14696	3359	10673	319	10	135	3	1	4	21	11	3	5	14544	152	5339
270223	대구광역시	동구	혁신동	13893	10927	3634	6746	272	3	111	0	4	6	28	7	2	4	10817	110	2966
270301	대구광역시	서구	내당1동	7110	5219	859	4153	88	2	45	1	2	0	15	2	2	4	5173	46	1891
270302	대구광역시	서구	내당2·3동	7809	5661	895	4520	87	4	55	2	0	2	13	4	4	2	5588	73	2148
270303	대구광역시	서구	내당4동	13663	10356	1771	8207	158	9	78	0	0	4	19	3	4	2	10255	101	3307
270304	대구광역시	서구	비산1동	8421	6184	955	4971	86	8	83	2	0	0	9	7	1	3	6125	59	2237
270305	대구광역시	서구	비산2·3동	7810	5664	853	4575	76	4	54	1	0	2	32	3	3	6	5609	55	2146
270306	대구광역시	서구	비산4동	8329	6201	979	4953	113	3	48	0	1	0	11	7	7	2	6124	77	2128
270307	대구광역시	서구	비산5동	5297	3901	593	3153	66	2	31	1	2	3	4	3	2	0	3860	41	1396
270308	대구광역시	서구	비산6동	6758	5023	785	4005	91	4	44	4	0	2	13	4	2	1	4955	68	1735
270309	대구광역시	서구	비산7동	8402	5903	891	4779	67	3	73	0	2	0	15	2	7	2	5841	62	2499
270310	대구광역시	서구	평리1동	7170	5367	878	4270	72	4	54	2	2	1	12	2	1	3	5301	66	1803
270311	대구광역시	서구	평리2동	6881	5336	1018	4125	76	2	41	0	1	2	4	2	3	2	5276	60	1545
270312	대구광역시	서구	평리3동	8709	6402	1085	5049	110	2	69	3	1	1	16	6	3	2	6347	55	2307
270313	대구광역시	서구	평리4동	13868	10229	1713	8099	146	5	120	4	1	2	16	5	2	5	10118	111	3639
270314	대구광역시	서구	평리5동	1646	1243	199	1001	20	0	11	0	2	0	0	2	1	0	1236	7	403
270315	대구광역시	서구	평리6동	3252	2342	330	1927	28	1	24	0	0	1	6	3	5	0	2325	17	910
270316	대구광역시	서구	상중이동	15502	11751	2133	9166	199	6	91	2	2	0	26	9	5	1	11640	111	3751
270317	대구광역시	서구	원대동	6619	4777	749	3836	66	2	50	2	0	0	8	3	3	3	4722	55	1842
270401	대구광역시	남구	이천동	9339	7170	1475	5412	141	4	48	6	0	6	8	5	2	2	7109	61	2169
270402	대구광역시	남구	봉덕1동	7648	5480	1048	4213	82	11	55	0	2	2	9	1	0	2	5425	55	2168
270403	대구광역시	남구	봉덕2동	9850	7746	1353	6115	127	3	53	5	0	0	19	5	1	2	7683	63	2104
270404	대구광역시	남구	봉덕3동	13137	9363	1664	7364	127	4	69	7	1	3	18	3	1	6	9267	96	3774
270405	대구광역시	남구	대명1동	9551	7007	1415	5277	133	3	74	3	3	4	16	9	2	2	6941	66	2544
270406	대구광역시	남구	대명2동	8541	6269	1356	4559	150	7	76	4	6	3	17	5	0	1	6184	85	2272
270407	대구광역시	남구	대명3동	8894	6215	1250	4669	110	9	73	7	2	2	19	2	3	2	6148	67	2679
270408	대구광역시	남구	대명4동	9205	6757	1208	5276	90	5	57	11	2	2	12	5	1	3	6672	85	2448
270409	대구광역시	남구	대명5동	5232	3741	758	2799	79	2	35	4	0	2	8	4	0	2	3693	48	1491
270410	대구광역시	남구	대명6동	7952	5787	1143	4355	118	11	77	6	1	2	13	0	2	3	5731	56	2165
270411	대구광역시	남구	대명9동	12602	8957	1922	6639	171	9	107	5	2	3	12	3	1	1	8875	82	3645
270412	대구광역시	남구	대명10동	7698	5659	1031	4406	80	1	49	4	1	3	16	1	1	2	5595	64	2039
270413	대구광역시	남구	대명11동	7334	5249	851	4154	90	5	55	4	2	1	13	3	2	4	5184	65	2085
270501	대구광역시	북구	고성동	4984	4150	919	3068	101	2	21	0	0	3	4	1	0	1	4120	30	834
270502	대구광역시	북구	칠성동	16746	12823	2657	9702	247	4	62	1	5	2	20	3	6	3	12712	111	3923
270503	대구광역시	북구	침산1동	3446	2605	429	2064	36	1	35	0	0	0	8	2	4	0	2579	26	841
270504	대구광역시	북구	침산2동	13648	11082	2534	8147	216	5	69	2	4	4	11	4	2	5	11003	79	2566
270505	대구광역시	북구	침산3동	15382	12302	2583	9244	256	10	76	4	1	1	16	6	5	4	12206	96	3080
270506	대구광역시	북구	노원동	10463	8206	1361	6553	129	4	67	0	0	0	17	6	2	2	8141	65	2257
270508	대구광역시	북구	산격1동	8055	5946	994	4688	76	4	72	2	0	4	15	3	5	2	5865	81	2109
270509	대구광역시	북구	산격2동	9393	7590	1460	5863	130	7	40	0	0	3	13	3	3	7	7529	61	1803
270510	대구광역시	북구	산격3동	7528	5409	1188	3960	119	3	49	2	4	2	12	5	2	4	5350	59	2119
270511	대구광역시	북구	산격4동	7751	5958	1188	4506	109	1	61	1	1	1	12	1	6	5	5892	66	1793
270512	대구광역시	북구	복현1동	6704	4807	1043	3511	126	4	48	3	0	3	5	5	1	1	4750	57	1897
270513	대구광역시	북구	복현2동	21792	16646	3729	12236	359	8	121	2	3	7	25	6	2	7	16505	141	5146
270514	대구광역시	북구	대현동	13967	10590	2154	8002	205	2	87	4	1	2	17	3	3	1	10481	109	3377
270516	대구광역시	북구	검단동	5756	4428	844	3417	59	2	51	0	2	0	7	3	1	0	4386	42	1328
270517	대구광역시	북구	무태조야동	26706	20467	4870	14826	373	4	185	1	2	6	38	14	3	6	20328	139	6239
270518	대구광역시	북구	관문동	26299	20439	4737	14934	372	5	160	3	2	3	40	3	6	6	20271	168	5860
270519	대구광역시	북구	태전1동	17445	12964	2657	9741	266	7	150	0	3	7	16	6	6	1	12860	104	4481
270520	대구광역시	북구	태전2동	19705	14986	3173	11232	268	8	146	1	0	2	28	10	3	9	14880	106	4719
270521	대구광역시	북구	구암동	26088	20257	5098	14279	476	7	197	1	6	5	22	9	6	5	20111	146	5831
270522	대구광역시	북구	관음동	14221	10879	2115	8330	210	6	103	2	2	4	17	6	2	4	10801	78	3342
270523	대구광역시	북구	읍내동	20678	15487	3167	11621	315	12	152	1	3	4	23	7	5	7	15317	170	5191
270524	대구광역시	북구	동천동	22404	18003	4664	12533	469	11	127	7	4	3	25	11	1	9	17864	139	4401
270525	대구광역시	북구	국우동	20923	16084	4264	11148	354	6	149	1	0	4	14	10	2	3	15955	129	4839
270601	대구광역시	수성구	범어1동	12161	10046	1858	7871	179	5	44	3	1	5	12	5	2	6	9991	55	2115
270602	대구광역시	수성구	범어2동	10499	8024	1301	6490	116	4	42	2	2	3	8	3	1	0	7972	52	2475
270603	대구광역시	수성구	범어3동	11526	9506	1910	7306	183	4	39	0	2	4	6	4	0	2	9460	46	2020
270604	대구광역시	수성구	범어4동	12198	9864	2068	7472	191	1	45	2	0	5	8	5	2	0	9799	65	2334
270605	대구광역시	수성구	만촌1동	17766	14394	2980	10920	246	12	81	0	2	3	31	5	2	2	14284	110	3372
270606	대구광역시	수성구	만촌2동	8540	6648	1364	5004	128	3	52	0	1	1	16	2	1	2	6574	74	1892
270607	대구광역시	수성구	만촌3동	13007	10586	2175	8073	181	5	52	0	1	4	12	3	2	5	10513	73	2421
270608	대구광역시	수성구	수성1가동	13790	11159	2195	8603	182	4	64	2	0	3	19	3	3	5	11083	76	2631
270609	대구광역시	수성구	수성2·3가동	9905	8328	1373	6705	138	5	44	1	0	3	5	6	1	2	8283	45	1577
270610	대구광역시	수성구	수성4가동	11597	9495	1707	7490	158	4	47	0	1	1	7	8	3	3	9429	66	2102
270611	대구광역시	수성구	황금1동	16503	13779	2871	10523	233	1	52	1	1	4	16	2	1	4	13709	70	2724
270612	대구광역시	수성구	황금2동	8964	6456	1255	4985	86	4	42	2	1	2	8	3	3	5	6396	60	2508
270613	대구광역시	수성구	중동	9857	7383	1348	5806	92	3	53	0	1	0	14	0	0	3	7320	63	2474
270614	대구광역시	수성구	상동	13142	9957	1719	7935	142	2	70	1	0	9	14	2	0	4	9898	59	3185
270615	대구광역시	수성구	파동	9661	7629	1425	5942	120	3	67	2	3	3	14	7	4	1	7591	38	2032
270616	대구광역시	수성구	두산동	11610	8663	1501	6908	114	8	64	0	1	1	9	2	0	1	8609	54	2947
270617	대구광역시	수성구	지산1동	18176	13801	2629	10676	228	3	109	2	1	5	32	5	4	4	13698	103	4375
270618	대구광역시	수성구	지산2동	13989	10771	2175	8216	196	2	70	2	1	2	21	4	2	2	10693	78	3218
270619	대구광역시	수성구	범물1동	9791	7630	1355	6003	117	2	58	0	0	6	19	3	5	2	7570	60	2161
270620	대구광역시	수성구	범물2동	13000	10522	2276	7896	185	1	67	3	2	2	11	10	4	0	10457	65	2478
270621	대구광역시	수성구	고산1동	23206	19047	4750	13532	441	8	119	5	3	3	28	8	3	6	18906	141	4159
270622	대구광역시	수성구	고산2동	21167	17113	3918	12564	360	9	115	3	1	7	19	11	5	3	17015	98	4054
270623	대구광역시	수성구	고산3동	24070	19451	4516	14175	433	7	139	3	3	5	26	6	1	5	19319	132	4619
270701	대구광역시	달서구	성당동	17389	12713	2320	9846	223	6	122	2	5	2	42	1	6	8	12583	130	4676
270703	대구광역시	달서구	두류1·2동	11820	8124	1355	6379	151	6	71	0	3	5	37	7	5	2	8021	103	3696
270705	대구광역시	달서구	두류3동	7638	6113	1097	4782	105	4	50	0	0	1	18	1	2	2	6062	51	1525
270706	대구광역시	달서구	본리동	16584	13099	2845	9761	231	7	97	2	5	3	51	7	0	1	13010	89	3485
270707	대구광역시	달서구	감삼동	19552	14843	2729	11478	298	3	121	2	0	2	53	12	3	3	14704	139	4709
270708	대구광역시	달서구	죽전동	11120	8073	1508	6208	156	4	77	1	2	1	15	4	3	2	7981	92	3047
270709	대구광역시	달서구	장기동	14200	11211	2267	8474	238	3	101	3	0	2	17	5	4	5	11119	92	2989
270710	대구광역시	달서구	용산1동	23906	18709	3737	14256	356	7	142	2	1	6	34	9	4	4	18558	151	5197
270711	대구광역시	달서구	용산2동	22674	17712	3765	13169	403	7	170	2	1	0	30	11	4	6	17568	144	4962
270712	대구광역시	달서구	이곡1동	18998	14805	3212	10937	343	9	123	4	3	9	36	9	2	9	14696	109	4193
270713	대구광역시	달서구	이곡2동	14869	11916	2416	9042	215	7	92	0	2	2	15	6	2	0	11799	117	2953
270714	대구광역시	달서구	신당동	24628	17515	3766	12939	368	13	171	2	3	4	23	12	10	5	17316	199	7113
270715	대구광역시	달서구	월성1동	22406	17851	4269	12900	381	6	112	0	1	8	17	10	5	7	17716	135	4555
270716	대구광역시	달서구	월성2동	15426	12054	2617	8936	217	7	99	4	6	6	33	7	5	11	11948	106	3372
270717	대구광역시	달서구	진천동	38165	29403	6261	21987	578	14	222	2	6	5	60	12	11	6	29164	239	8762
270718	대구광역시	달서구	상인1동	27088	22247	4560	16906	404	6	130	5	1	4	44	7	1	4	22072	175	4841
270719	대구광역시	달서구	상인2동	16640	12376	2380	9493	238	4	107	5	1	2	22	8	5	4	12269	107	4264
270720	대구광역시	달서구	상인3동	10622	8099	1510	6259	130	6	61	2	2	1	27	8	4	5	8015	84	2523
270721	대구광역시	달서구	도원동	28753	23242	5086	17276	456	9	156	8	5	8	35	10	9	9	23067	175	5511
270722	대구광역시	달서구	송현1동	16389	11637	2160	8928	203	11	138	4	3	5	38	8	5	6	11509	128	4752
270723	대구광역시	달서구	송현2동	13920	9852	1746	7638	180	4	98	1	0	8	46	7	6	5	9739	113	4068
270724	대구광역시	달서구	본동	11384	8700	1667	6714	132	4	66	1	1	2	28	8	2	2	8627	73	2684
270725	대구광역시	달서구	유천동	21124	17328	4569	12150	368	4	104	0	1	5	13	7	1	5	17227	101	3796
270801	대구광역시	달성군	화원읍	36427	27752	5377	21208	560	15	254	3	4	6	51	25	12	11	27526	226	8675
270802	대구광역시	달성군	논공읍	14289	9979	2087	7420	175	7	150	3	1	3	14	17	7	8	9892	87	4310
270803	대구광역시	달성군	다사읍	60750	46519	11385	33238	991	20	411	7	10	7	61	26	10	20	46186	333	14231
270804	대구광역시	달성군	가창면	6142	4700	779	3741	70	1	35	0	3	2	9	3	3	4	4650	50	1442
270805	대구광역시	달성군	하빈면	3910	3176	572	2509	24	4	12	1	2	2	6	4	6	5	3147	29	734
270809	대구광역시	달성군	구지면	14393	10230	2665	7068	216	37	124	3	1	4	8	9	6	3	10144	86	4163
270810	대구광역시	달성군	유가읍	20953	16239	4835	10649	390	10	159	3	1	2	18	27	4	1	16099	140	4714
270811	대구광역시	달성군	옥포읍	19005	14766	2979	11188	274	5	154	3	1	5	26	8	2	7	14652	114	4239
270812	대구광역시	달성군	현풍읍	16381	11348	2616	8177	196	7	176	1	3	3	19	14	7	7	11226	122	5033
280101	인천광역시	중구	신포동	4403	3073	1418	1508	75	1	29	0	1	0	6	1	0	1	3040	33	1330
280102	인천광역시	중구	연안동	5186	3539	1500	1929	56	0	30	0	1	1	7	2	0	0	3526	13	1647
280103	인천광역시	중구	신흥동	9986	6860	3104	3446	158	5	81	1	1	1	7	7	1	5	6817	43	3126
280104	인천광역시	중구	도원동	3698	2668	1143	1396	63	1	32	1	1	2	3	2	2	2	2648	20	1030
280105	인천광역시	중구	율목동	2720	1798	758	930	44	3	22	1	0	0	5	2	1	1	1767	31	922
280106	인천광역시	중구	동인천동	5037	3256	1342	1731	83	1	53	1	0	2	5	2	2	3	3225	31	1781
280109	인천광역시	중구	영종동	15051	10423	4847	5128	243	4	104	1	0	3	5	14	2	2	10353	70	4628
280110	인천광역시	중구	용유동	3143	2206	719	1417	30	0	26	0	0	1	0	0	1	0	2194	12	937
280111	인천광역시	중구	운서동	27545	20247	10847	8209	663	14	230	5	3	6	32	17	2	4	20032	215	7298
280112	인천광역시	중구	영종1동	28463	21325	11303	9109	537	6	170	4	4	3	10	9	1	9	21165	160	7138
280113	인천광역시	중구	개항동	5292	3551	1573	1808	73	0	55	2	0	1	5	4	1	2	3524	27	1741
280201	인천광역시	동구	만석동	5687	4132	2031	1896	125	4	34	0	1	0	4	9	1	4	4109	23	1555
280202	인천광역시	동구	화수1·화평동	4823	3537	1600	1774	86	5	31	1	0	0	3	2	4	1	3507	30	1286
280203	인천광역시	동구	화수2동	5923	4252	1893	2133	123	2	42	0	0	1	6	4	2	5	4211	41	1671
280204	인천광역시	동구	송현1·2동	8414	6625	3178	3125	212	4	44	2	1	2	4	6	4	2	6584	41	1789
280205	인천광역시	동구	송현3동	2948	2141	950	1083	54	2	22	2	0	0	2	4	2	1	2122	19	807
280206	인천광역시	동구	송림1동	1281	948	397	518	21	0	7	0	0	0	0	0	1	0	944	4	333
280207	인천광역시	동구	송림2동	2578	1865	773	1013	42	0	15	1	0	0	4	4	0	1	1853	12	713
280208	인천광역시	동구	송림3·5동	5930	4292	2012	2056	130	3	29	1	0	0	5	8	1	1	4246	46	1638
280209	인천광역시	동구	송림4동	4530	3411	1757	1494	105	4	23	1	1	1	1	3	1	0	3391	20	1119
280210	인천광역시	동구	송림6동	4934	3664	1749	1725	112	5	28	3	1	2	4	1	1	1	3632	32	1270
280211	인천광역시	동구	금창동	2517	1791	757	937	44	1	22	0	0	0	6	3	0	0	1770	21	726
280301	인천광역시	미추홀구	숭의1·3동	10710	6619	3143	3120	184	10	86	0	2	4	6	3	2	4	6564	55	4091
280302	인천광역시	미추홀구	숭의2동	13114	8725	4264	3996	233	5	132	3	1	2	5	8	3	3	8655	70	4389
280304	인천광역시	미추홀구	숭의4동	13165	8703	4011	4223	229	6	123	2	1	2	8	8	4	6	8623	80	4462
280305	인천광역시	미추홀구	용현1·4동	14041	9332	3782	5039	242	10	81	3	0	4	10	6	3	6	9186	146	4709
280306	인천광역시	미추홀구	용현2동	14763	10699	5099	5087	300	2	102	1	0	1	3	5	2	8	10610	89	4064
280307	인천광역시	미추홀구	용현3동	7046	4782	2017	2550	112	3	46	0	1	4	7	2	3	4	4749	33	2264
280309	인천광역시	미추홀구	용현5동	36041	25522	12137	12218	716	14	207	2	2	6	13	13	5	5	25338	184	10519
280310	인천광역시	미추홀구	학익1동	24711	18442	8652	8935	505	2	133	3	6	3	12	20	7	7	18285	157	6269
280311	인천광역시	미추홀구	학익2동	15074	11007	4930	5551	308	8	97	2	4	3	4	2	1	2	10912	95	4067
280312	인천광역시	미추홀구	도화1동	18172	11501	5417	5464	310	8	146	8	3	4	17	13	3	8	11401	100	6671
280313	인천광역시	미추홀구	도화2·3동	25352	18249	9051	8208	554	8	208	4	2	4	19	15	2	4	18079	170	7103
280315	인천광역시	미추홀구	주안1동	17083	9672	4821	4237	296	5	161	4	2	1	7	12	1	4	9551	121	7411
280316	인천광역시	미추홀구	주안2동	13500	8745	3850	4465	237	6	94	2	0	1	12	5	2	4	8678	67	4755
280317	인천광역시	미추홀구	주안3동	7111	4727	2238	2240	134	4	47	3	0	4	4	9	3	2	4688	39	2384
280318	인천광역시	미추홀구	주안4동	10939	7119	2848	3960	153	1	77	1	0	4	5	4	4	4	7061	58	3820
280319	인천광역시	미추홀구	주안5동	17244	12084	5917	5594	311	13	126	6	1	1	5	9	5	3	11991	93	5160
280320	인천광역시	미추홀구	주안6동	17204	11841	5587	5731	302	8	107	3	0	1	11	7	2	2	11761	80	5363
280321	인천광역시	미추홀구	주안7동	12338	9074	4142	4491	243	4	95	3	2	3	14	4	5	5	9011	63	3264
280322	인천광역시	미추홀구	주안8동	16468	11642	5544	5541	313	7	113	2	4	2	6	14	2	3	11551	91	4826
280323	인천광역시	미추홀구	관교동	12188	9297	4024	4841	270	5	52	2	0	3	7	6	4	3	9217	80	2891
280324	인천광역시	미추홀구	문학동	11859	7271	3712	3174	177	4	118	2	2	2	3	4	3	2	7203	68	4588
280401	인천광역시	연수구	옥련1동	14478	10441	4656	5299	288	3	87	3	2	4	5	10	2	1	10360	81	4037
280402	인천광역시	연수구	옥련2동	17064	13005	6034	6377	373	7	95	4	0	0	6	11	3	4	12914	91	4059
280403	인천광역시	연수구	선학동	14302	10294	4732	5091	271	11	87	3	1	1	12	6	3	4	10222	72	4008
280404	인천광역시	연수구	연수1동	16241	10917	5007	5391	279	9	104	3	4	3	6	12	1	5	10824	93	5324
280405	인천광역시	연수구	연수2동	17431	13201	5913	6635	374	5	90	7	1	10	12	12	3	2	13064	137	4230
280406	인천광역시	연수구	연수3동	13197	9866	4581	4794	301	3	68	2	4	2	10	12	1	8	9786	80	3331
280407	인천광역시	연수구	청학동	20262	14090	6364	7047	385	10	130	2	0	1	18	3	11	8	13979	111	6172
280408	인천광역시	연수구	동춘1동	18869	14685	6989	7019	456	9	77	7	0	4	6	8	5	5	14585	100	4184
280409	인천광역시	연수구	동춘2동	14596	11581	5606	5435	360	11	59	3	0	2	10	6	1	3	11496	85	3015
280410	인천광역시	연수구	동춘3동	13874	11428	5385	5596	314	4	41	2	1	5	3	12	1	2	11366	62	2446
280411	인천광역시	연수구	송도1동	26431	20995	8945	11271	521	9	72	6	3	2	10	11	3	3	20856	139	5436
280412	인천광역시	연수구	송도2동	24915	20153	8200	11331	426	6	60	1	0	1	9	6	1	2	20043	110	4762
280413	인천광역시	연수구	송도3동	33330	26676	11685	13893	794	10	93	2	1	1	7	5	5	5	26501	175	6654
280414	인천광역시	연수구	송도4동	17416	13979	5780	7706	337	4	47	3	1	2	6	3	2	3	13894	85	3437
280415	인천광역시	연수구	송도5동	26921	21097	9047	11246	571	4	87	1	3	1	6	7	0	4	20977	120	5824
280501	인천광역시	남동구	구월1동	24615	18414	9115	8446	557	6	125	5	6	6	9	16	4	3	18298	116	6201
280502	인천광역시	남동구	구월2동	26634	20840	9981	9988	553	9	119	10	4	1	13	7	3	7	20695	145	5794
280503	인천광역시	남동구	구월3동	23590	14419	7025	6551	448	9	173	3	1	3	6	12	4	6	14241	178	9171
280504	인천광역시	남동구	구월4동	12631	8197	3975	3774	224	10	100	1	2	4	1	8	2	6	8107	90	4434
280505	인천광역시	남동구	간석1동	17975	12917	6201	6080	351	10	106	3	3	3	4	12	3	7	12783	134	5058
280506	인천광역시	남동구	간석2동	16539	11730	5261	5936	298	4	92	1	2	2	13	14	3	1	11627	103	4809
280507	인천광역시	남동구	간석3동	21833	14514	7191	6512	407	10	200	2	4	5	15	18	5	7	14376	138	7319
280508	인천광역시	남동구	간석4동	21990	14981	7174	7036	432	11	139	3	1	3	20	17	2	10	14848	133	7009
280509	인천광역시	남동구	만수1동	14783	10418	4912	4880	336	7	141	2	2	4	14	9	2	7	10316	102	4365
280510	인천광역시	남동구	만수2동	19456	14504	7535	6274	402	13	103	4	3	8	13	13	2	6	14376	128	4952
280511	인천광역시	남동구	만수3동	14657	10503	5286	4723	291	8	87	0	2	3	3	13	1	4	10421	82	4154
280512	인천광역시	남동구	만수4동	16878	12724	5967	6132	397	5	91	10	0	6	8	12	1	3	12632	92	4154
280513	인천광역시	남동구	만수5동	13068	8975	4408	4118	237	7	107	2	0	2	3	7	3	7	8901	74	4093
280514	인천광역시	남동구	만수6동	20339	15246	7355	7156	461	20	122	2	3	2	10	8	1	9	15149	97	5093
280515	인천광역시	남동구	장수서창동	15119	11500	5501	5507	303	5	71	2	2	1	16	3	3	5	11419	81	3619
280516	인천광역시	남동구	남촌도림동	16225	11278	5429	5242	329	12	124	2	2	5	11	18	6	5	11185	93	4947
280517	인천광역시	남동구	논현1동	24281	18082	9131	8143	487	11	145	1	1	2	16	24	3	3	17967	115	6199
280518	인천광역시	남동구	논현2동	26149	19156	9471	8727	521	10	176	4	3	6	21	21	5	7	18972	184	6993
280519	인천광역시	남동구	논현고잔동	30191	23435	11769	10711	609	10	127	2	4	1	18	16	5	7	23279	156	6756
280520	인천광역시	남동구	서창2동	28002	21841	11659	9225	622	7	141	4	3	1	20	11	4	6	21703	138	6161
280601	인천광역시	부평구	부평1동	29554	21264	10148	10058	658	12	182	6	4	4	8	15	2	7	21104	160	8290
280602	인천광역시	부평구	부평2동	12291	8380	4236	3699	231	7	106	2	1	4	10	18	3	3	8320	60	3911
280603	인천광역시	부평구	부평3동	10917	7610	3719	3479	238	8	72	4	1	3	10	10	3	2	7549	61	3307
280604	인천광역시	부평구	부평4동	31497	21139	11168	8861	634	7	209	6	3	1	18	16	5	9	20937	202	10358
280605	인천광역시	부평구	부평5동	25107	15623	8574	6250	400	8	203	2	0	2	20	13	7	7	15486	137	9484
280606	인천광역시	부평구	부평6동	12589	8867	4590	3817	264	6	79	5	2	0	9	9	2	1	8784	83	3722
280607	인천광역시	부평구	산곡1동	9769	7113	3364	3391	221	4	48	1	0	0	8	13	0	4	7054	59	2656
280608	인천광역시	부평구	산곡2동	22373	17211	8518	7900	515	6	99	3	2	6	13	12	4	3	17081	130	5162
280609	인천광역시	부평구	산곡3동	17756	13426	5898	6912	380	9	78	2	2	5	12	16	2	8	13324	102	4330
280610	인천광역시	부평구	산곡4동	16153	13108	6394	6189	334	5	68	2	0	6	4	14	4	3	13023	85	3045
280611	인천광역시	부평구	청천1동	6206	4139	2117	1826	118	2	27	2	0	2	4	5	0	3	4106	33	2067
280612	인천광역시	부평구	청천2동	25162	17826	8924	8025	506	11	150	7	1	5	10	16	5	9	17669	157	7336
280613	인천광역시	부평구	갈산1동	13929	9864	5067	4288	291	11	97	4	0	1	9	9	5	7	9789	75	4065
280614	인천광역시	부평구	갈산2동	15297	11586	5520	5559	303	7	86	2	1	5	4	7	5	3	11502	84	3711
280615	인천광역시	부평구	삼산1동	26162	19312	10376	8001	514	12	175	4	3	11	16	11	4	9	19136	176	6850
280616	인천광역시	부평구	삼산2동	21425	17010	8956	7356	468	4	77	5	0	4	12	10	8	4	16904	106	4415
280617	인천광역시	부평구	부개1동	13083	9161	4474	4255	221	9	94	1	1	1	15	7	5	3	9086	75	3922
280618	인천광역시	부평구	부개2동	15765	11836	5932	5324	366	5	76	4	1	3	10	12	2	3	11738	98	3929
280619	인천광역시	부평구	부개3동	25389	19872	10203	8722	606	14	131	7	4	0	22	20	3	6	19738	134	5517
280620	인천광역시	부평구	일신동	10265	7914	3924	3598	221	5	79	4	0	0	9	4	3	3	7850	64	2351
280621	인천광역시	부평구	십정1동	11951	8789	4336	4045	211	6	82	5	4	4	5	6	2	7	8713	76	3162
280622	인천광역시	부평구	십정2동	17541	11553	5410	5568	282	7	122	2	3	4	20	5	7	10	11440	113	5988
280701	인천광역시	계양구	효성1동	22354	16531	8548	7215	452	5	134	1	1	5	16	11	4	7	16399	132	5823
280702	인천광역시	계양구	효성2동	22806	16168	8220	7202	411	9	137	2	3	2	18	19	4	7	16034	134	6638
280703	인천광역시	계양구	계산1동	15169	9974	4934	4506	289	11	104	5	1	4	8	13	6	5	9886	88	5195
280704	인천광역시	계양구	계산2동	15301	11386	5898	4917	316	9	109	6	0	3	7	13	6	9	11293	93	3915
280705	인천광역시	계양구	계산3동	16894	12815	6642	5527	367	15	91	5	1	10	8	26	1	3	12696	119	4079
280706	인천광역시	계양구	계산4동	19970	15680	8125	6895	452	6	84	5	1	3	5	7	3	2	15588	92	4290
280707	인천광역시	계양구	작전1동	21378	15667	8114	6745	481	12	129	7	0	5	8	12	4	7	15524	143	5711
280708	인천광역시	계양구	작전2동	16678	11962	6202	5186	326	7	119	2	3	4	12	11	4	2	11878	84	4716
280709	인천광역시	계양구	작전서운동	25365	18535	9701	7990	505	5	131	9	2	8	6	17	4	8	18386	149	6830
280710	인천광역시	계양구	계양1동	14566	10436	5096	4791	312	4	90	5	2	3	9	18	1	7	10338	98	4130
280711	인천광역시	계양구	계양2동	27801	19522	10039	8453	559	17	190	6	3	7	18	28	7	8	19335	187	8279
280712	인천광역시	계양구	계양3동	19160	14245	7967	5605	409	9	132	3	3	4	8	11	6	0	14157	88	4915
280801	인천광역시	서구	검암경서동	33717	24154	12903	10074	736	15	196	6	6	3	15	11	6	5	23976	178	9563
280802	인천광역시	서구	연희동	33952	23218	11682	10284	696	12	257	10	9	7	11	14	8	9	22999	219	10734
280803	인천광역시	서구	청라1동	22141	16908	8574	7676	444	4	82	3	1	6	5	7	3	4	16809	99	5233
280804	인천광역시	서구	가정1동	22533	16259	8438	7011	521	8	116	5	3	0	11	17	5	9	16144	115	6274
280805	인천광역시	서구	가정2동	5530	3946	1952	1781	113	6	35	2	1	1	6	4	3	1	3905	41	1584
280806	인천광역시	서구	가정3동	8138	5913	2904	2677	174	7	74	2	1	4	11	8	1	1	5864	49	2225
280807	인천광역시	서구	신현원창동	24272	17706	8527	8358	472	12	144	3	3	5	14	11	7	7	17563	143	6566
280808	인천광역시	서구	석남1동	18609	12424	6025	5739	323	12	169	8	3	5	17	5	7	4	12317	107	6185
280809	인천광역시	서구	석남2동	11540	8364	4018	3958	204	5	83	4	2	3	2	8	4	4	8295	69	3176
280810	인천광역시	서구	석남3동	10960	7139	3509	3242	198	4	97	2	0	4	7	7	2	3	7075	64	3821
280811	인천광역시	서구	가좌1동	10648	7057	3476	3187	183	7	110	1	6	2	7	5	4	3	6991	66	3591
280812	인천광역시	서구	가좌2동	16183	12545	6006	5959	347	8	96	1	1	1	8	14	1	3	12445	100	3638
280813	인천광역시	서구	가좌3동	14107	10120	4817	4782	268	8	114	4	0	6	11	11	3	5	10029	91	3987
280814	인천광역시	서구	가좌4동	8046	5786	2700	2781	172	1	56	2	1	4	3	10	3	4	5737	49	2260
280819	인천광역시	서구	청라2동	33755	26205	12738	12469	686	6	125	3	5	6	13	4	3	12	26070	135	7550
280821	인천광역시	서구	청라3동	21861	17139	8478	8016	421	7	102	1	3	3	5	9	3	2	17050	89	4722
280822	인천광역시	서구	검단동	26006	17903	9193	7858	475	7	216	2	1	6	10	13	6	7	17794	109	8103
280823	인천광역시	서구	불로대곡동	17263	12554	6535	5458	319	9	121	4	2	2	7	10	3	4	12474	80	4709
280824	인천광역시	서구	원당동	17470	12824	7125	5149	359	3	79	1	2	0	7	11	1	4	12741	83	4646
280825	인천광역시	서구	당하동	21291	15987	8507	6750	450	9	130	3	4	4	11	15	1	5	15889	98	5304
280826	인천광역시	서구	오류왕길동	18764	13291	6771	5909	342	12	117	2	0	4	18	11	1	4	13191	100	5473
280827	인천광역시	서구	마전동	16695	12456	6553	5327	368	5	79	3	0	1	9	14	4	3	12366	90	4239
280828	인천광역시	서구	아라동	12305	9729	4926	4362	309	4	51	0	2	0	3	5	0	2	9664	65	2576
280901	인천광역시	강화군	강화읍	17906	12928	4964	7364	302	1	169	5	2	2	10	10	6	6	12841	87	4978
280902	인천광역시	강화군	선원면	6247	4753	1783	2752	108	2	54	2	1	2	6	4	2	2	4718	35	1494
280903	인천광역시	강화군	불은면	3938	2907	1019	1798	45	1	18	0	0	1	0	1	1	0	2884	23	1031
280904	인천광역시	강화군	길상면	6055	4591	1485	2912	81	2	36	2	1	1	7	2	2	4	4535	56	1464
280905	인천광역시	강화군	화도면	3598	2640	794	1747	43	0	26	3	0	1	2	0	2	1	2619	21	958
280906	인천광역시	강화군	양도면	3408	2558	825	1638	39	0	27	1	2	0	1	3	3	1	2540	18	850
280907	인천광역시	강화군	내가면	2581	2026	598	1352	36	2	21	2	0	0	4	0	0	2	2017	9	555
280908	인천광역시	강화군	하점면	3344	2456	752	1591	52	1	21	2	0	1	0	4	4	2	2430	26	888
280909	인천광역시	강화군	양사면	1517	1168	395	725	23	0	17	0	1	0	1	0	1	0	1163	5	349
280910	인천광역시	강화군	송해면	2878	2163	689	1375	49	1	20	1	0	0	0	3	1	1	2140	23	715
280911	인천광역시	강화군	교동면	2368	1815	520	1195	32	4	32	0	0	0	0	5	3	1	1792	23	553
280912	인천광역시	강화군	삼산면	1791	1328	373	897	23	0	17	1	0	1	1	2	3	4	1322	6	463
280913	인천광역시	강화군	서도면	502	389	88	287	5	1	2	0	0	0	1	0	1	1	386	3	113
281001	인천광역시	옹진군	북도면	1437	1104	270	748	19	1	11	3	0	2	0	2	1	3	1060	44	333
281002	인천광역시	옹진군	연평면	1507	1046	349	587	30	2	46	2	0	0	1	3	3	1	1024	22	461
281003	인천광역시	옹진군	백령면	3741	2798	950	1665	63	0	64	0	1	0	3	0	1	3	2750	48	943
281004	인천광역시	옹진군	대청면	1109	880	224	582	20	2	28	2	0	0	1	1	0	1	861	19	229
281005	인천광역시	옹진군	덕적면	1285	996	346	604	18	1	12	1	1	0	1	1	0	3	988	8	289
281006	인천광역시	옹진군	자월면	893	680	184	466	10	0	6	0	1	0	0	1	2	0	670	10	213
281007	인천광역시	옹진군	영흥면	4988	3724	1496	2061	70	4	32	4	1	2	2	3	3	4	3682	42	1264
290101	광주광역시	동구	충장동	3942	2748	2204	432	54	4	30	1	0	1	0	0	0	0	2726	22	1194
290102	광주광역시	동구	동명동	3474	2587	2081	419	46	0	15	1	1	0	0	4	0	1	2568	19	887
290103	광주광역시	동구	계림1동	7984	6092	4982	947	70	4	31	2	0	1	0	11	1	2	6051	41	1892
290104	광주광역시	동구	계림2동	7529	6336	5232	934	87	3	34	0	0	3	0	6	2	4	6305	31	1193
290105	광주광역시	동구	산수1동	5603	4142	3531	494	72	1	19	2	0	0	0	4	2	1	4126	16	1461
290106	광주광역시	동구	산수2동	7421	5910	4978	790	70	2	24	1	0	0	0	9	0	1	5875	35	1511
290107	광주광역시	동구	지산1동	3107	2379	1897	390	46	0	24	2	0	1	0	0	0	0	2360	19	728
290108	광주광역시	동구	지산2동	3593	2713	2233	394	44	0	11	0	0	0	0	6	0	2	2690	23	880
290109	광주광역시	동구	서남동	2693	1943	1521	359	29	1	11	0	0	0	0	3	0	3	1927	16	750
290110	광주광역시	동구	학동	5431	4416	3458	848	61	1	14	1	2	0	0	2	1	3	4391	25	1015
290111	광주광역시	동구	학운동	9488	7751	6252	1310	96	4	30	1	0	3	0	7	2	5	7710	41	1737
290112	광주광역시	동구	지원1동	5691	4511	3854	530	63	3	23	1	0	0	1	6	1	1	4483	28	1180
290113	광주광역시	동구	지원2동	10082	7842	6674	958	97	1	34	3	0	4	3	7	0	3	7784	58	2240
290201	광주광역시	서구	양동	3529	2844	2502	279	19	2	13	1	0	1	0	7	0	3	2827	17	685
290202	광주광역시	서구	양3동	3533	2841	2465	286	39	2	19	1	0	0	0	5	1	1	2819	22	692
290203	광주광역시	서구	농성1동	7756	5642	4787	701	70	0	34	3	0	1	0	5	0	1	5602	40	2114
290204	광주광역시	서구	농성2동	4290	3197	2678	393	59	3	29	1	1	0	1	2	1	2	3170	27	1093
290205	광주광역시	서구	광천동	6094	4705	3911	660	71	0	17	1	2	1	2	2	0	2	4669	36	1389
290206	광주광역시	서구	유덕동	7988	6437	5547	706	91	2	39	0	0	1	0	12	1	3	6402	35	1551
290207	광주광역시	서구	치평동	23665	18976	15698	2724	305	5	97	2	2	4	2	24	5	8	18876	100	4689
290208	광주광역시	서구	상무1동	18792	13948	11772	1746	210	5	97	1	1	1	1	17	2	9	13862	86	4844
290209	광주광역시	서구	상무2동	17694	12882	10982	1543	146	5	73	1	2	3	2	28	5	6	12796	86	4812
290210	광주광역시	서구	화정1동	12082	8934	7440	1199	165	2	42	2	3	3	1	14	1	6	8878	56	3148
290211	광주광역시	서구	화정2동	14395	11967	9980	1694	159	7	48	5	1	1	2	11	3	3	11914	53	2428
290212	광주광역시	서구	화정3동	7168	5494	4593	732	69	5	42	1	0	0	1	5	2	1	5451	43	1674
290213	광주광역시	서구	화정4동	12094	9992	8436	1268	136	2	65	1	0	1	1	11	2	3	9926	66	2102
290214	광주광역시	서구	서창동	3726	2900	2479	342	40	0	8	4	0	0	0	5	1	5	2884	16	826
290215	광주광역시	서구	금호1동	14582	11515	9908	1312	144	1	48	2	0	2	0	12	1	4	11434	81	3067
290216	광주광역시	서구	금호2동	20723	17464	15207	1837	227	6	66	3	1	3	0	16	1	1	17368	96	3259
290217	광주광역시	서구	풍암동	25687	20660	17399	2713	286	1	80	4	0	4	2	38	2	8	20537	123	5027
290218	광주광역시	서구	동천동	11609	9696	8391	1051	129	6	46	1	0	1	1	15	1	7	9649	47	1913
290301	광주광역시	남구	양림동	5608	4614	3925	574	50	1	20	1	0	0	0	8	1	0	4580	34	994
290302	광주광역시	남구	방림1동	5245	4196	3579	500	55	0	26	0	0	0	0	3	2	1	4166	30	1049
290303	광주광역시	남구	방림2동	6311	4991	4321	522	68	2	24	2	0	0	0	8	0	5	4952	39	1320
290304	광주광역시	남구	봉선1동	11156	8852	7442	1137	126	1	53	4	0	2	2	9	4	4	8784	68	2304
290305	광주광역시	남구	봉선2동	18110	14767	11168	3208	216	8	41	3	1	2	4	9	4	7	14671	96	3343
290306	광주광역시	남구	사직동	3876	2826	2420	341	25	1	16	0	1	0	0	4	0	3	2811	15	1050
290307	광주광역시	남구	월산동	6368	4734	4088	518	53	0	33	1	0	1	0	5	1	3	4703	31	1634
290308	광주광역시	남구	월산4동	6437	4684	4023	519	59	3	43	0	0	2	1	3	0	2	4655	29	1753
290309	광주광역시	남구	월산5동	5563	4228	3710	409	47	3	23	0	1	1	0	6	0	4	4204	24	1335
290310	광주광역시	남구	백운1동	9370	7710	6647	848	97	1	50	3	3	0	1	8	3	5	7666	44	1660
290311	광주광역시	남구	백운2동	5021	3833	3215	476	74	3	27	1	0	1	0	2	0	2	3801	32	1188
290312	광주광역시	남구	주월1동	15163	11895	10092	1497	149	11	55	1	2	1	0	23	5	4	11840	55	3268
290313	광주광역시	남구	주월2동	6314	4930	4314	494	57	1	22	1	1	0	3	8	4	1	4906	24	1384
290314	광주광역시	남구	효덕동	11979	9878	8342	1283	145	4	35	1	0	1	2	9	0	3	9825	53	2101
290315	광주광역시	남구	송암동	12092	9500	7940	1299	136	1	42	2	2	0	0	9	3	5	9439	61	2592
290316	광주광역시	남구	대촌동	4893	3890	3470	319	38	2	20	1	2	0	1	9	5	5	3872	18	1003
290317	광주광역시	남구	진월동	20184	16538	14026	2048	246	9	71	2	1	4	2	10	3	5	16427	111	3646
290401	광주광역시	북구	중흥1동	3844	2853	2426	314	63	1	23	0	0	2	0	3	1	0	2833	20	991
290402	광주광역시	북구	중흥2동	5995	4678	3848	666	91	4	24	0	0	0	1	5	0	1	4640	38	1317
290403	광주광역시	북구	중흥3동	4086	3100	2557	427	50	4	25	3	1	1	1	3	2	2	3076	24	986
290404	광주광역시	북구	중앙동	2881	2081	1780	236	31	3	16	1	0	1	0	0	0	0	2068	13	800
290405	광주광역시	북구	임동	6978	5506	4774	582	81	3	16	3	1	0	1	4	1	3	5469	37	1472
290406	광주광역시	북구	신안동	9483	6879	5824	821	112	2	55	4	1	0	1	14	0	1	6835	44	2604
290407	광주광역시	북구	용봉동	25724	19856	16074	3051	379	8	121	5	0	5	2	27	4	8	19684	172	5868
290408	광주광역시	북구	운암1동	14012	11820	9930	1597	171	2	50	0	0	1	0	6	0	1	11758	62	2192
290409	광주광역시	북구	운암2동	10554	8231	7132	880	110	3	35	1	1	3	2	22	2	3	8194	37	2323
290410	광주광역시	북구	운암3동	9689	7907	6737	959	102	2	39	2	0	1	0	16	1	5	7864	43	1782
290411	광주광역시	북구	동림동	15512	12311	10664	1300	181	3	75	2	1	1	2	23	2	0	12254	57	3201
290412	광주광역시	북구	우산동	9242	7285	6201	898	98	3	34	0	2	1	0	6	1	3	7247	38	1957
290413	광주광역시	북구	풍향동	3873	3013	2491	435	39	4	15	0	1	1	1	3	0	1	2991	22	860
290414	광주광역시	북구	문화동	14232	10988	9364	1335	138	3	49	2	0	1	3	8	0	6	10909	79	3244
290415	광주광역시	북구	문흥1동	12334	10238	8762	1200	121	8	56	1	1	0	1	15	6	1	10172	66	2096
290416	광주광역시	북구	문흥2동	11848	9308	7937	1094	142	6	57	5	1	0	0	14	0	5	9261	47	2540
290417	광주광역시	북구	두암1동	6476	5062	4382	542	63	1	31	1	0	0	1	2	1	1	5025	37	1414
290418	광주광역시	북구	두암2동	12265	9439	8117	1046	129	5	53	2	5	0	1	13	1	5	9377	62	2826
290419	광주광역시	북구	두암3동	10919	8380	7287	874	97	5	44	4	1	3	0	3	2	5	8325	55	2539
290420	광주광역시	북구	삼각동	10911	8677	7404	982	145	3	62	2	0	2	1	14	2	3	8620	57	2234
290421	광주광역시	북구	일곡동	20874	17012	14491	1987	257	12	107	2	2	2	0	23	4	8	16895	117	3862
290422	광주광역시	북구	매곡동	12260	10412	8981	1139	160	5	60	0	0	1	0	16	1	4	10367	45	1848
290423	광주광역시	북구	오치1동	8232	6222	5107	890	96	3	73	2	0	0	0	4	2	4	6181	41	2010
290424	광주광역시	북구	오치2동	11687	9218	7755	1142	165	4	68	3	1	3	3	9	3	9	9165	53	2469
290425	광주광역시	북구	석곡동	2240	1840	1604	185	30	1	4	2	0	0	1	2	0	2	1831	9	400
290426	광주광역시	북구	건국동	15544	12200	10565	1305	170	3	79	2	1	0	1	11	1	4	12142	58	3344
290427	광주광역시	북구	양산동	26248	20023	17268	2144	292	6	145	2	1	3	4	27	2	4	19898	125	6225
290428	광주광역시	북구	신용동	18465	14709	12608	1687	228	11	94	1	3	1	2	9	0	2	14646	63	3756
290501	광주광역시	광산구	송정1동	8911	6977	5978	772	110	4	41	2	0	1	1	14	1	8	6932	45	1934
290502	광주광역시	광산구	송정2동	6242	4916	4131	607	99	2	37	1	0	0	1	11	1	2	4892	24	1326
290503	광주광역시	광산구	도산동	11621	9084	7827	960	120	6	75	2	0	1	1	23	3	6	9024	60	2537
290504	광주광역시	광산구	신흥동	3711	2836	2451	307	28	1	22	0	1	0	1	3	0	3	2817	19	875
290505	광주광역시	광산구	어룡동	21368	16263	14070	1646	261	5	115	6	3	5	2	29	3	12	16157	106	5105
290506	광주광역시	광산구	우산동	22780	17462	14884	1972	280	7	138	5	2	6	2	33	1	8	17338	124	5318
290507	광주광역시	광산구	월곡1동	10286	8191	7101	790	134	4	53	5	0	2	0	29	2	2	8122	69	2095
290508	광주광역시	광산구	월곡2동	11190	8778	7577	919	131	6	53	0	0	1	1	23	1	6	8718	60	2412
290509	광주광역시	광산구	비아동	6601	5266	4603	528	65	4	34	2	0	0	0	4	0	3	5243	23	1335
290510	광주광역시	광산구	첨단1동	20578	16899	14090	2245	296	4	108	7	0	0	3	17	4	6	16780	119	3679
290511	광주광역시	광산구	첨단2동	29292	22464	19035	2647	408	15	150	2	2	1	4	31	2	13	22310	154	6828
290512	광주광역시	광산구	신가동	13357	10673	9225	1114	162	0	70	3	1	2	3	15	2	3	10600	73	2684
290513	광주광역시	광산구	운남동	23329	19133	16629	1849	297	7	133	4	1	0	1	60	3	13	18997	136	4196
290514	광주광역시	광산구	신창동	24354	19132	16465	2037	297	9	142	8	2	1	2	36	2	6	19007	125	5222
290515	광주광역시	광산구	수완동	46605	36594	30703	4836	561	14	206	2	4	2	3	44	4	15	36394	200	10011
290516	광주광역시	광산구	하남동	17459	13457	11626	1432	184	5	89	3	1	1	2	18	6	5	13372	85	4002
290517	광주광역시	광산구	임곡동	2082	1666	1467	151	21	1	7	2	0	0	0	3	0	2	1654	12	416
290518	광주광역시	광산구	동곡동	1682	1354	1174	127	16	0	10	1	1	0	0	5	1	5	1340	14	328
290519	광주광역시	광산구	평동	4178	3316	2926	284	33	3	26	3	2	1	0	12	0	1	3291	25	862
290520	광주광역시	광산구	삼도동	1928	1546	1368	104	10	1	1	1	1	1	0	8	1	13	1509	37	382
290521	광주광역시	광산구	본량동	1650	1274	1087	122	20	2	8	0	0	1	1	4	5	4	1254	20	376
300101	대전광역시	동구	중앙동	4652	3324	1421	1776	54	4	30	1	0	1	3	1	1	3	3295	29	1328
300102	대전광역시	동구	신인동	11111	8661	3860	4397	233	3	87	2	0	2	3	11	1	3	8602	59	2450
300103	대전광역시	동구	효동	16846	12138	6009	5575	321	7	105	3	1	4	7	16	4	1	12053	85	4708
300105	대전광역시	동구	판암1동	9576	7089	3193	3505	213	4	79	3	3	1	6	8	2	4	7021	68	2487
300106	대전광역시	동구	판암2동	8210	6022	2623	3104	125	2	77	4	0	3	2	8	2	3	5953	69	2188
300107	대전광역시	동구	용운동	16468	12094	5667	5859	301	5	120	1	1	2	17	13	4	7	11997	97	4374
300109	대전광역시	동구	대동	10282	7325	3188	3739	196	3	90	1	1	1	5	6	3	7	7240	85	2957
300110	대전광역시	동구	자양동	9265	6264	2683	3218	166	10	86	0	0	3	7	7	4	4	6188	76	3001
300112	대전광역시	동구	가양1동	11405	8255	3613	4253	183	4	84	1	3	2	9	8	4	7	8171	84	3150
300113	대전광역시	동구	가양2동	14205	9754	4404	4899	211	13	111	3	0	1	13	10	2	3	9670	84	4451
300114	대전광역시	동구	용전동	16364	10899	4968	5331	302	7	132	7	4	3	10	17	5	5	10791	108	5465
300115	대전광역시	동구	성남동	9404	6943	3222	3389	164	4	72	2	4	4	5	2	0	1	6869	74	2461
300117	대전광역시	동구	홍도동	9063	6300	2778	3197	170	8	83	0	1	1	4	7	0	7	6256	44	2763
300118	대전광역시	동구	삼성동	10748	7745	3409	3987	155	3	87	1	3	3	8	7	2	6	7671	74	3003
300120	대전광역시	동구	대청동	1935	1451	481	913	30	1	17	1	0	0	0	5	1	1	1450	1	484
300121	대전광역시	동구	산내동	14336	10243	4859	4919	250	2	108	0	2	4	2	11	5	7	10169	74	4093
300201	대전광역시	중구	은행선화동	12126	7909	3515	3965	240	5	96	0	0	2	4	8	1	6	7842	67	4217
300202	대전광역시	중구	목동	10020	7963	4172	3435	232	5	61	4	1	1	0	4	1	3	7919	44	2057
300203	대전광역시	중구	중촌동	10163	7680	3497	3805	184	7	75	1	0	3	3	11	5	2	7593	87	2483
300204	대전광역시	중구	대흥동	10782	7645	3514	3765	200	3	74	1	0	4	7	8	1	5	7582	63	3137
300205	대전광역시	중구	문창동	4117	2948	1240	1563	66	1	32	0	0	0	5	8	2	2	2919	29	1169
300206	대전광역시	중구	석교동	12777	8783	3649	4715	194	2	95	4	1	8	10	14	6	5	8703	80	3994
300207	대전광역시	중구	대사동	4714	3343	1311	1855	109	0	32	2	1	1	2	5	0	0	3318	25	1371
300208	대전광역시	중구	부사동	5484	3794	1591	2017	88	6	35	3	0	2	1	5	0	1	3749	45	1690
300209	대전광역시	중구	용두동	8153	6144	2810	3022	183	8	56	1	2	2	4	5	2	1	6096	48	2009
300210	대전광역시	중구	오류동	8794	6733	2800	3634	162	4	54	3	1	3	11	8	2	2	6684	49	2061
300211	대전광역시	중구	태평1동	9968	7700	3551	3858	165	4	52	2	1	3	6	5	2	5	7654	46	2268
300212	대전광역시	중구	태평2동	18278	14000	5730	7782	297	2	74	2	0	2	9	13	1	5	13917	83	4278
300213	대전광역시	중구	유천1동	6624	4845	2013	2594	147	2	49	1	0	2	4	4	1	0	4817	28	1779
300214	대전광역시	중구	유천2동	10847	7934	3263	4373	150	1	64	2	0	0	3	14	3	4	7877	57	2913
300215	대전광역시	중구	문화1동	15583	12044	5005	6552	281	4	80	1	1	2	1	12	3	7	11949	95	3539
300216	대전광역시	중구	문화2동	10619	7849	3349	4147	198	1	73	2	0	3	8	10	3	3	7797	52	2770
300217	대전광역시	중구	산성동	20871	14414	6062	7651	340	3	167	2	5	6	12	19	4	11	14282	132	6457
300301	대전광역시	서구	복수동	15925	11929	5772	5626	279	6	97	0	0	2	7	17	3	12	11821	108	3996
300302	대전광역시	서구	도마1동	12620	8663	3471	4799	187	7	94	2	0	3	12	12	3	2	8592	71	3957
300303	대전광역시	서구	도마2동	14059	9952	4113	5393	206	7	117	1	1	4	13	10	3	3	9871	81	4107
300304	대전광역시	서구	정림동	13153	10097	4664	4980	251	3	101	3	2	0	6	8	8	2	10028	69	3056
300305	대전광역시	서구	변동	12586	8595	3717	4471	212	6	100	3	1	3	5	6	1	2	8527	68	3991
300306	대전광역시	서구	용문동	11389	7832	3251	4127	275	3	92	1	0	1	3	10	1	2	7766	66	3557
300307	대전광역시	서구	탄방동	19574	13644	6087	6905	382	10	109	4	1	3	6	13	0	3	13523	121	5930
300308	대전광역시	서구	둔산1동	14127	12227	5077	6674	318	5	56	0	3	4	5	5	3	2	12152	75	1900
300309	대전광역시	서구	둔산2동	23858	18503	8695	8925	595	9	108	4	1	2	9	12	5	2	18367	136	5355
300310	대전광역시	서구	둔산3동	16108	13165	5543	7191	267	6	57	1	3	3	7	8	2	3	13091	74	2943
300311	대전광역시	서구	괴정동	15349	9494	4382	4541	284	6	158	1	1	1	2	7	2	4	9389	105	5855
300312	대전광역시	서구	가장동	9419	7241	3076	3881	151	1	64	2	0	1	1	3	1	3	7184	57	2178
300313	대전광역시	서구	내동	17167	12813	5528	6714	320	6	109	10	1	4	8	14	2	2	12718	95	4354
300314	대전광역시	서구	갈마1동	17533	11965	5294	6073	325	3	122	1	2	5	10	17	1	6	11859	106	5568
300315	대전광역시	서구	갈마2동	19830	12885	6099	6079	358	8	186	3	3	3	10	10	1	7	12767	118	6945
300316	대전광역시	서구	월평1동	10697	7422	3398	3574	223	4	103	0	3	1	10	5	2	0	7323	99	3275
300317	대전광역시	서구	월평2동	12327	9694	4112	5109	287	5	61	2	2	7	6	4	1	7	9603	91	2633
300318	대전광역시	서구	월평3동	14903	12194	5446	6219	354	4	53	2	1	5	4	7	0	2	12097	97	2709
300319	대전광역시	서구	만년동	10109	8233	3787	4021	255	10	40	2	3	2	2	6	2	3	8133	100	1876
300320	대전광역시	서구	가수원동	29594	22097	10486	10603	644	8	145	2	1	5	10	18	3	3	21928	169	7497
300321	대전광역시	서구	관저1동	12711	9884	4919	4489	296	5	66	2	0	0	2	6	0	6	9791	93	2827
300322	대전광역시	서구	관저2동	34688	25928	13543	11145	760	12	214	8	1	4	7	26	5	6	25731	197	8760
300323	대전광역시	서구	기성동	3392	2367	893	1308	49	3	22	3	5	3	1	5	4	8	2304	63	1025
300401	대전광역시	유성구	진잠동	18256	13248	6400	6218	329	8	142	1	1	2	8	17	11	4	13141	107	5008
300402	대전광역시	유성구	온천1동	23916	16854	7298	8680	480	8	161	5	2	2	9	16	4	7	16672	182	7062
300403	대전광역시	유성구	온천2동	27453	20909	8892	10961	609	14	136	4	3	1	10	26	4	9	20669	240	6544
300404	대전광역시	유성구	노은1동	17366	14091	6832	6647	383	6	79	3	3	4	5	7	8	4	13981	110	3275
300405	대전광역시	유성구	노은2동	15939	12596	6129	5911	380	7	58	2	0	2	10	2	2	1	12504	92	3343
300406	대전광역시	유성구	신성동	18643	15010	6438	7894	371	8	96	3	2	4	13	8	2	2	14841	169	3633
300407	대전광역시	유성구	전민동	19699	16025	7630	7705	443	9	75	1	0	4	18	7	3	3	15898	127	3674
300408	대전광역시	유성구	구즉동	20140	14906	7971	6122	485	14	138	4	2	4	8	16	6	2	14772	134	5234
300409	대전광역시	유성구	관평동	20577	16813	8313	7754	500	9	76	3	1	4	7	6	1	7	16681	132	3764
300410	대전광역시	유성구	원신흥동	20698	16178	7630	7884	400	3	116	4	3	3	5	15	3	1	16067	111	4520
300411	대전광역시	유성구	노은3동	25788	20797	10632	9310	561	11	89	4	5	7	10	25	4	6	20664	133	4991
300412	대전광역시	유성구	학하동	12502	9536	4219	4928	209	7	68	1	0	1	5	4	2	1	9445	91	2966
300413	대전광역시	유성구	상대동	15189	11952	5072	6397	337	3	63	4	3	2	7	7	1	0	11896	56	3237
300501	대전광역시	대덕구	오정동	11345	7910	3372	4141	186	6	91	2	2	2	6	13	5	3	7829	81	3435
300502	대전광역시	대덕구	대화동	6021	4052	1799	1960	100	6	62	3	1	1	6	17	2	8	3965	87	1969
300503	대전광역시	대덕구	회덕동	9689	7127	3148	3636	180	5	65	3	3	2	4	12	3	2	7063	64	2562
300504	대전광역시	대덕구	비래동	13138	9741	4486	4772	253	8	93	3	0	5	6	19	2	8	9655	86	3397
300505	대전광역시	대덕구	송촌동	20285	15468	7528	7188	421	7	145	4	3	2	6	19	4	5	15332	136	4817
300506	대전광역시	대덕구	중리동	15352	10409	4727	5165	227	9	136	3	1	3	10	11	3	6	10301	108	4943
300507	대전광역시	대덕구	법1동	10121	7554	3467	3704	216	7	68	2	1	1	4	16	4	1	7491	63	2567
300508	대전광역시	대덕구	법2동	12842	9987	4459	5031	271	9	92	3	2	4	10	14	3	6	9904	83	2855
300509	대전광역시	대덕구	신탄진동	11289	8312	3758	4114	241	7	84	0	0	1	18	10	5	1	8239	73	2977
300510	대전광역시	대덕구	석봉동	11816	8861	4439	3987	263	8	73	2	1	1	9	9	4	1	8797	64	2955
300511	대전광역시	대덕구	덕암동	11145	7885	3788	3666	206	9	100	2	2	1	10	13	3	5	7805	80	3260
300512	대전광역시	대덕구	목상동	5429	3815	1975	1612	126	5	55	0	0	0	1	3	3	3	3783	32	1614
310101	울산광역시	중구	학성동	9915	7450	2411	4632	156	3	114	4	1	3	16	25	4	1	7370	80	2465
310102	울산광역시	중구	반구1동	13836	10466	4117	5698	309	6	160	4	1	2	16	40	2	8	10363	103	3370
310103	울산광역시	중구	반구2동	7283	5477	1908	3238	157	4	85	3	1	0	6	16	1	5	5424	53	1806
310104	울산광역시	중구	복산1동	3896	3021	1047	1822	81	1	31	3	2	1	2	4	3	1	2998	23	875
310105	울산광역시	중구	복산2동	8695	6697	2631	3690	200	2	83	2	1	1	9	22	2	3	6646	51	1998
310106	울산광역시	중구	성안동	15916	12090	5267	6230	304	5	152	2	2	3	4	37	4	7	12017	73	3826
310107	울산광역시	중구	중앙동	10452	7520	2127	5070	115	3	83	2	0	4	15	20	3	0	7442	78	2932
310109	울산광역시	중구	우정동	14314	11193	3744	6988	244	4	93	2	0	4	7	30	4	2	11122	71	3121
310110	울산광역시	중구	태화동	23334	18582	7286	10375	534	12	157	2	2	6	18	26	2	5	18425	157	4752
310111	울산광역시	중구	다운동	19192	14677	5139	8787	367	6	175	1	3	3	12	42	9	6	14550	127	4515
310112	울산광역시	중구	병영1동	17584	13633	5205	7674	407	6	139	4	1	2	24	39	7	3	13511	122	3951
310113	울산광역시	중구	병영2동	14588	10837	4400	5807	291	8	181	5	3	0	11	42	2	3	10753	84	3751
310114	울산광역시	중구	약사동	8177	6869	2947	3564	242	3	51	2	0	3	5	20	1	1	6839	30	1308
310201	울산광역시	남구	신정1동	15485	11494	3528	7458	214	2	147	6	4	1	16	24	3	5	11408	86	3991
310202	울산광역시	남구	신정2동	17125	13434	4424	8475	281	5	105	3	1	0	16	17	3	2	13332	102	3691
310203	울산광역시	남구	신정3동	13162	9911	3451	6016	221	1	114	2	3	3	15	15	1	3	9845	66	3251
310204	울산광역시	남구	신정4동	15629	12153	4642	6946	324	2	102	3	3	2	4	25	3	4	12060	93	3476
310205	울산광역시	남구	신정5동	7978	5908	2073	3549	138	1	85	0	1	3	5	11	2	3	5871	37	2070
310206	울산광역시	남구	달동	21521	15423	5553	9023	389	8	216	5	3	2	21	36	2	5	15263	160	6098
310207	울산광역시	남구	삼산동	39644	28730	11373	15955	724	8	324	10	2	4	14	77	4	12	28507	223	10914
310208	울산광역시	남구	삼호동	16822	12836	4658	7516	321	6	153	1	2	4	17	36	3	7	12724	112	3986
310209	울산광역시	남구	무거동	24358	19064	7350	10713	521	6	189	8	3	3	14	34	5	3	18849	215	5294
310210	울산광역시	남구	옥동	20081	16563	6260	9551	447	9	123	0	1	4	13	27	1	7	16443	120	3518
310211	울산광역시	남구	야음장생포동	8261	6087	1966	3812	134	4	74	6	0	1	12	14	5	2	6030	57	2174
310212	울산광역시	남구	대현동	21937	17097	6861	9408	428	9	168	1	0	4	12	52	8	5	16956	141	4840
310213	울산광역시	남구	수암동	13440	11151	4323	6334	305	3	75	3	1	3	2	13	2	6	11070	81	2289
310214	울산광역시	남구	선암동	10884	8147	3050	4625	216	2	120	2	2	2	10	29	1	4	8063	84	2737
310301	울산광역시	동구	방어동	30294	21082	9440	10244	630	13	416	18	1	6	15	82	8	9	20882	200	9212
310302	울산광역시	동구	일산동	5858	4527	1885	2365	121	4	63	7	0	4	4	20	3	1	4477	50	1331
310303	울산광역시	동구	화정동	14828	11161	5083	5323	399	8	158	7	0	6	8	40	5	9	11046	115	3667
310304	울산광역시	동구	대송동	9278	7006	3264	3231	257	4	118	6	4	0	6	32	2	5	6929	77	2272
310305	울산광역시	동구	전하1동	11085	8528	3803	4118	334	7	121	5	1	3	11	36	1	1	8441	87	2557
310306	울산광역시	동구	전하2동	16167	13245	6008	6337	525	6	157	8	2	2	8	51	3	6	13113	132	2922
310308	울산광역시	동구	남목1동	7173	5651	2515	2765	178	2	89	2	0	0	2	42	3	2	5600	51	1522
310309	울산광역시	동구	남목2동	15272	11859	5590	5395	460	8	189	12	2	3	7	65	1	5	11737	122	3413
310310	울산광역시	동구	남목3동	9296	7212	3368	3289	257	5	131	11	2	3	6	68	3	5	7148	64	2084
310401	울산광역시	북구	농소1동	25371	19024	8563	9289	616	16	281	10	4	1	25	66	9	5	18885	139	6347
310402	울산광역시	북구	농소2동	31679	24278	11896	10798	913	17	342	7	5	2	17	61	6	7	24071	207	7401
310403	울산광역시	북구	농소3동	26705	20494	10228	9033	715	10	210	9	1	5	20	89	6	9	20335	159	6211
310404	울산광역시	북구	강동동	11566	8687	3845	4404	249	0	104	4	0	0	4	20	2	3	8635	52	2879
310405	울산광역시	북구	효문동	21872	16498	7293	8048	665	6	221	6	0	3	18	83	7	6	16356	142	5374
310406	울산광역시	북구	송정동	27933	22359	10791	10095	906	15	246	8	2	3	12	68	7	5	22158	201	5574
310407	울산광역시	북구	양정동	8005	6393	3097	2824	280	1	78	6	1	0	6	30	0	2	6325	68	1612
310408	울산광역시	북구	염포동	8299	6414	2994	2920	273	4	120	9	0	1	3	30	1	2	6357	57	1885
310501	울산광역시	울주군	온산읍	16564	11207	4314	6240	245	6	210	2	2	1	16	35	3	8	11082	125	5357
310502	울산광역시	울주군	언양읍	22239	16918	6229	9802	395	11	217	6	3	5	22	60	11	3	16764	154	5321
310503	울산광역시	울주군	온양읍	21670	15756	6333	8541	439	12	222	3	2	11	11	38	5	8	15625	131	5914
310504	울산광역시	울주군	범서읍	49266	38769	17183	19657	1077	9	369	12	1	7	28	106	10	15	38474	295	10497
310505	울산광역시	울주군	서생면	6512	4829	1239	3406	80	2	52	1	0	0	5	7	3	3	4798	31	1683
310507	울산광역시	울주군	웅촌면	6837	5132	1688	3179	113	3	64	3	3	1	6	15	2	6	5083	49	1705
310508	울산광역시	울주군	두동면	3558	2570	739	1716	54	0	22	0	0	1	2	8	1	2	2545	25	988
310509	울산광역시	울주군	두서면	2853	2207	616	1460	41	2	20	0	1	6	3	6	3	15	2173	34	646
310510	울산광역시	울주군	상북면	6922	5231	1592	3382	105	2	55	5	2	3	12	16	3	3	5180	51	1691
310512	울산광역시	울주군	삼동면	1642	1357	373	922	29	0	13	1	0	1	3	4	1	0	1347	10	285
310513	울산광역시	울주군	청량읍	14226	10742	3999	6137	292	7	165	7	1	7	13	21	2	4	10655	87	3484
310514	울산광역시	울주군	삼남읍	17193	12335	4204	7460	281	5	207	4	4	2	22	19	1	5	12214	121	4858
410101	경기도	수원시장안구	파장동	19438	14541	7257	6610	374	8	112	3	1	2	20	13	1	4	14405	136	4897
410102	경기도	수원시장안구	율천동	32061	25400	12734	11416	702	19	130	7	3	9	21	13	7	10	25071	329	6661
410103	경기도	수원시장안구	정자1동	21770	16986	8594	7681	415	10	110	2	1	2	11	23	6	7	16862	124	4784
410104	경기도	수원시장안구	정자2동	25440	18869	9329	8639	474	16	154	0	3	4	25	32	5	8	18689	180	6571
410105	경기도	수원시장안구	정자3동	30237	24776	13461	10187	771	10	119	2	7	3	15	19	3	8	24605	171	5461
410106	경기도	수원시장안구	영화동	16587	11394	5377	5553	218	7	117	2	3	4	9	15	3	7	11315	79	5193
410107	경기도	수원시장안구	송죽동	15320	11135	5645	5000	266	9	79	1	0	4	7	9	2	1	11023	112	4185
410108	경기도	수원시장안구	조원1동	21846	15739	7759	7268	381	8	146	2	2	2	25	12	10	0	15615	124	6107
410109	경기도	수원시장안구	조원2동	15062	12477	5765	6162	362	5	59	2	2	2	20	4	0	3	12386	91	2585
410110	경기도	수원시장안구	연무동	13248	9203	4080	4748	175	4	84	1	3	3	8	13	2	6	9127	76	4045
410201	경기도	수원시권선구	세류1동	8564	6657	3156	3187	177	3	48	2	3	4	8	8	0	1	6597	60	1907
410202	경기도	수원시권선구	세류2동	19233	12248	6019	5626	279	9	151	2	3	7	16	14	2	4	12132	116	6985
410203	경기도	수원시권선구	세류3동	15572	10405	5119	4820	218	11	110	0	1	0	12	9	1	4	10305	100	5167
410204	경기도	수원시권선구	평동	31017	22629	11413	10149	563	10	221	5	2	4	20	15	3	8	22413	216	8388
410205	경기도	수원시권선구	서둔동	28982	19526	10053	8520	473	10	217	8	3	5	22	20	9	7	19347	179	9456
410206	경기도	수원시권선구	구운동	19046	13965	7106	6232	295	6	134	4	8	5	16	12	2	5	13825	140	5081
410208	경기도	수원시권선구	권선1동	19304	13229	6272	6306	313	7	131	4	0	5	7	9	5	6	13065	164	6075
410209	경기도	수원시권선구	권선2동	34669	27486	13318	13002	699	12	151	5	4	6	22	16	4	10	27249	237	7183
410210	경기도	수원시권선구	곡선동	25840	18023	9205	7967	460	8	160	1	3	5	11	16	6	7	17849	174	7817
410211	경기도	수원시권선구	입북동	12238	9740	5372	3978	204	3	81	2	1	3	9	8	2	7	9670	70	2498
410212	경기도	수원시권선구	금곡동	34055	26533	14220	11230	641	14	137	4	1	6	23	30	0	12	26318	215	7522
410213	경기도	수원시권선구	호매실동	32194	24158	13870	9306	615	13	123	4	4	6	11	15	7	8	23982	176	8036
410301	경기도	수원시팔달구	행궁동	9207	6191	2787	3124	144	4	67	2	0	2	8	4	0	2	6144	47	3016
410304	경기도	수원시팔달구	매교동	5530	3852	1843	1826	89	2	44	2	1	2	6	5	1	3	3824	28	1678
410305	경기도	수원시팔달구	매산동	8433	5465	2421	2813	123	4	47	1	0	0	5	8	1	3	5426	39	2968
410306	경기도	수원시팔달구	고등동	15388	11280	5491	5257	306	5	102	1	3	1	8	12	5	4	11195	85	4108
410307	경기도	수원시팔달구	화서1동	17656	12522	6273	5707	297	7	119	4	3	0	10	23	2	5	12450	72	5134
410308	경기도	수원시팔달구	화서2동	19160	15356	7710	7001	419	7	88	3	2	2	13	7	3	1	15256	100	3804
410309	경기도	수원시팔달구	지동	9253	6442	2977	3211	102	4	78	1	0	3	8	8	3	3	6398	44	2811
410310	경기도	수원시팔달구	우만1동	16525	11380	5553	5278	254	11	120	3	1	2	14	10	5	2	11253	127	5145
410311	경기도	수원시팔달구	우만2동	13403	10587	4834	5245	322	5	56	1	0	4	8	8	2	1	10486	101	2816
410312	경기도	수원시팔달구	인계동	29571	19171	9032	9223	477	5	167	2	0	5	10	12	4	7	18944	227	10400
410401	경기도	수원시영통구	매탄1동	13765	10601	4830	5306	284	4	58	1	1	2	7	9	1	4	10507	94	3164
410402	경기도	수원시영통구	매탄2동	11675	8718	4195	4136	222	5	62	1	2	2	6	11	2	3	8647	71	2957
410403	경기도	수원시영통구	매탄3동	26054	19770	9791	9039	550	20	114	8	2	4	8	16	2	11	19565	205	6284
410404	경기도	수원시영통구	매탄4동	16449	12053	5942	5538	327	8	92	2	0	2	15	15	3	3	11947	106	4396
410405	경기도	수원시영통구	원천동	27301	20666	9091	10724	511	9	107	6	1	4	22	12	6	6	20499	167	6635
410407	경기도	수원시영통구	영통1동	24157	19408	9838	8755	528	7	93	5	1	4	4	8	3	5	19251	157	4749
410408	경기도	수원시영통구	영통2동	21173	16757	8298	7740	425	4	71	2	0	1	11	4	6	2	16564	193	4416
410410	경기도	수원시영통구	광교1동	37488	30656	13611	15795	879	11	81	3	0	9	4	16	7	3	30419	237	6832
410411	경기도	수원시영통구	광교2동	20267	16346	7644	8076	404	6	71	3	4	5	13	13	1	5	16245	101	3921
410412	경기도	수원시영통구	영통3동	24341	19371	9364	9126	534	11	92	3	2	4	11	11	2	0	19160	211	4970
410413	경기도	수원시영통구	망포1동	19740	15367	7511	7225	417	7	68	2	1	3	4	8	0	5	15251	116	4373
410414	경기도	수원시영통구	망포2동	20289	16889	8627	7633	430	8	63	1	1	0	5	9	2	3	16782	107	3400
410501	경기도	성남시수정구	신흥1동	11750	8098	4880	2923	154	2	47	0	2	2	5	21	1	4	8041	57	3652
410502	경기도	성남시수정구	신흥2동	13283	10455	4908	5154	238	3	49	1	1	3	7	12	1	0	10377	78	2828
410503	경기도	성남시수정구	신흥3동	10226	7184	4047	2902	113	3	44	1	0	0	7	15	1	3	7136	48	3042
410504	경기도	성남시수정구	태평1동	13383	9884	5663	3853	195	3	47	2	0	2	4	20	2	4	9795	89	3499
410505	경기도	성남시수정구	태평2동	11674	8086	4720	3052	144	2	62	0	0	2	11	21	1	6	8021	65	3588
410506	경기도	성남시수정구	태평3동	11464	8430	4894	3227	140	2	62	2	0	1	8	25	4	3	8368	62	3034
410507	경기도	성남시수정구	태평4동	9872	6826	3973	2550	133	2	66	0	2	1	2	18	2	3	6752	74	3046
410508	경기도	성남시수정구	수진1동	10446	7073	4155	2635	126	5	46	1	2	3	6	13	4	2	6998	75	3373
410509	경기도	성남시수정구	수진2동	12380	9234	5155	3784	144	3	52	1	1	4	5	24	0	2	9175	59	3146
410510	경기도	성남시수정구	단대동	11161	8386	4565	3512	162	3	44	4	1	1	14	9	0	4	8319	67	2775
410511	경기도	성남시수정구	산성동	5010	3885	2314	1421	85	2	22	0	0	1	1	11	0	3	3860	25	1125
410512	경기도	성남시수정구	양지동	8936	6929	4086	2586	126	7	52	1	1	0	5	21	0	2	6887	42	2007
410513	경기도	성남시수정구	복정동	8975	6750	3673	2801	173	1	35	2	1	2	6	3	0	4	6701	49	2225
410514	경기도	성남시수정구	신촌동	3253	2481	1111	1274	48	0	17	0	2	1	0	2	0	0	2455	26	772
410515	경기도	성남시수정구	고등동	7795	6392	3026	3130	126	2	36	0	0	2	2	11	2	2	6339	53	1403
410516	경기도	성남시수정구	시흥동	2500	1927	757	1113	33	0	8	0	0	0	2	5	0	1	1919	8	573
410517	경기도	성남시수정구	위례동	31932	25361	11648	12944	493	6	68	3	4	5	16	22	1	12	25222	139	6571
410601	경기도	성남시중원구	성남동	26681	18868	10502	7653	364	6	98	4	2	2	16	36	4	11	18698	170	7813
410602	경기도	성남시중원구	중앙동	9613	7057	3919	2905	115	3	34	0	3	1	8	15	3	5	7011	46	2556
410603	경기도	성남시중원구	금광1동	5743	4145	2383	1611	81	5	23	0	2	0	1	12	2	2	4122	23	1598
410604	경기도	성남시중원구	금광2동	19042	13592	7505	5583	278	7	70	1	1	1	7	39	3	5	13500	92	5450
410605	경기도	성남시중원구	은행1동	8141	6158	3643	2228	145	6	44	4	1	2	7	18	0	2	6100	58	1983
410606	경기도	성남시중원구	은행2동	18476	13566	7863	5175	258	2	97	6	3	5	11	29	4	9	13462	104	4910
410607	경기도	성남시중원구	상대원1동	19208	13600	7951	5134	253	8	97	1	0	1	6	22	4	7	13484	116	5608
410608	경기도	성남시중원구	상대원2동	11013	7634	4443	2897	123	7	51	0	0	4	9	25	3	3	7565	69	3379
410609	경기도	성남시중원구	상대원3동	10788	7635	4566	2810	113	3	59	0	0	3	8	18	4	4	7588	47	3153
410610	경기도	성남시중원구	하대원동	16303	12863	7098	5320	249	5	59	1	1	1	5	25	1	7	12772	91	3440
410611	경기도	성남시중원구	도촌동	18921	15138	8270	6356	318	3	70	4	0	2	7	17	2	5	15054	84	3783
410701	경기도	성남시분당구	분당동	17687	13868	5835	7568	311	5	47	4	0	4	3	9	1	5	13792	76	3819
410702	경기도	성남시분당구	수내1동	14092	11481	4335	6792	212	4	26	0	1	4	5	1	0	2	11382	99	2611
410703	경기도	성남시분당구	수내2동	7559	6477	2387	3918	125	0	12	1	0	1	1	2	0	2	6449	28	1082
410704	경기도	성남시분당구	수내3동	10055	8151	3610	4272	176	0	28	3	0	1	8	6	0	2	8106	45	1904
410705	경기도	성남시분당구	정자1동	22755	17654	5452	11739	283	5	37	0	3	1	10	5	1	5	17541	113	5101
410706	경기도	성남시분당구	정자2동	13668	11143	5091	5641	246	5	47	3	1	1	10	7	3	7	11062	81	2525
410707	경기도	성남시분당구	정자3동	12242	10062	4387	5324	243	6	24	0	0	3	8	7	0	3	10005	57	2180
410708	경기도	성남시분당구	서현1동	24321	19651	7672	11370	394	5	59	4	3	3	8	11	2	3	19534	117	4670
410709	경기도	성남시분당구	서현2동	14990	12515	5530	6577	242	5	34	2	1	2	12	12	5	2	12424	91	2475
410710	경기도	성남시분당구	이매1동	18456	15356	5912	9008	277	0	38	4	1	2	11	7	3	6	15269	87	3100
410711	경기도	성남시분당구	이매2동	10172	8607	3141	5250	131	0	21	1	2	2	7	2	2	0	8559	48	1565
410712	경기도	성남시분당구	야탑1동	14990	12442	5592	6460	225	5	40	3	2	2	18	7	0	2	12356	86	2548
410713	경기도	성남시분당구	야탑2동	12778	10751	4050	6385	204	2	28	0	1	7	8	2	1	2	10690	61	2027
410714	경기도	성남시분당구	야탑3동	20502	16025	7946	7466	371	7	62	1	2	3	17	23	3	6	15907	118	4477
410715	경기도	성남시분당구	금곡동	20700	16433	6603	9242	356	2	56	2	1	10	16	11	2	2	16303	130	4267
410716	경기도	성남시분당구	구미동	22432	17853	7366	9881	372	5	57	1	2	7	22	14	0	6	17733	120	4579
410717	경기도	성남시분당구	구미1동	15600	13117	5861	6810	286	2	34	1	1	4	8	5	3	3	13018	99	2483
410718	경기도	성남시분당구	판교동	18313	15412	6540	8391	357	3	25	1	0	4	6	4	4	5	15340	72	2901
410719	경기도	성남시분당구	삼평동	17619	14498	6668	7300	356	11	41	2	2	3	12	14	1	1	14411	87	3121
410720	경기도	성남시분당구	백현동	19978	16375	7491	8336	355	3	54	2	2	3	5	6	2	1	16260	115	3603
410721	경기도	성남시분당구	운중동	22559	18776	7936	10273	386	3	38	2	3	3	9	10	1	0	18664	112	3783
410722	경기도	성남시분당구	정자동	13735	10911	4350	6128	265	7	41	0	0	5	8	6	2	1	10813	98	2824
410801	경기도	의정부시	의정부1동	26776	15905	7925	7251	349	9	162	4	2	3	19	32	9	4	15769	136	10871
410802	경기도	의정부시	의정부2동	26491	17797	9376	7588	445	14	147	1	1	3	28	31	4	4	17642	155	8694
410804	경기도	의정부시	호원1동	28904	21852	11237	9727	506	6	136	7	3	8	11	25	8	9	21683	169	7052
410805	경기도	의정부시	호원2동	28198	21591	11121	9697	440	6	124	2	4	0	23	26	4	6	21453	138	6607
410806	경기도	의정부시	장암동	15985	12398	6409	5494	276	3	81	3	0	3	6	14	5	1	12295	103	3587
410807	경기도	의정부시	신곡1동	33293	24584	12887	10686	549	13	197	3	2	1	27	35	4	9	24413	171	8709
410808	경기도	의정부시	신곡2동	36884	27914	14258	12527	682	16	167	2	3	5	16	25	2	12	27715	199	8970
410809	경기도	의정부시	송산1동	34168	24097	12731	10311	581	7	182	0	4	8	22	51	6	11	23914	183	10071
410810	경기도	의정부시	송산2동	26171	19454	10709	7935	456	14	120	7	3	8	10	45	6	5	19318	136	6717
410811	경기도	의정부시	자금동	21579	15370	7946	6754	346	11	154	3	0	0	8	16	4	4	15246	124	6209
410815	경기도	의정부시	녹양동	17160	12445	6396	5519	298	8	114	3	2	2	13	13	3	3	12374	71	4715
410816	경기도	의정부시	흥선동	15988	10744	5619	4601	255	2	112	1	2	7	17	15	3	4	10638	106	5244
410817	경기도	의정부시	가능동	20902	13848	7114	6163	285	7	124	1	2	3	8	21	5	5	13738	110	7054
410818	경기도	의정부시	송산3동	33257	24349	13658	9763	558	4	150	4	2	8	7	37	1	9	24201	148	8908
410901	경기도	안양시만안구	안양1동	9861	7778	3756	3629	223	3	52	2	1	1	9	7	0	2	7685	93	2083
410902	경기도	안양시만안구	안양2동	16950	12221	6173	5511	281	4	102	1	1	4	21	9	3	4	12114	107	4729
410903	경기도	안양시만안구	안양3동	13840	10198	5221	4535	253	3	67	0	0	7	5	6	4	2	10103	95	3642
410904	경기도	안양시만안구	안양4동	6468	5002	2444	2351	111	3	35	1	0	1	3	2	2	2	4955	47	1466
410905	경기도	안양시만안구	안양5동	8677	6324	3054	3014	129	3	56	3	2	1	6	8	2	2	6280	44	2353
410906	경기도	안양시만안구	안양6동	20060	14311	7207	6501	354	6	99	2	3	1	13	6	4	3	14199	112	5749
410907	경기도	안양시만안구	안양7동	11856	9542	4778	4419	209	2	43	2	0	1	9	4	1	2	9470	72	2314
410908	경기도	안양시만안구	안양8동	9229	6730	3386	3064	150	4	54	3	0	4	5	6	3	2	6681	49	2499
410909	경기도	안양시만안구	안양9동	13327	9918	4845	4674	218	6	57	3	5	1	10	10	4	6	9839	79	3409
410910	경기도	안양시만안구	석수1동	15317	12442	6063	5924	289	7	52	3	1	3	13	3	3	3	12364	78	2875
410911	경기도	안양시만안구	석수2동	24833	19439	9962	8638	494	7	127	3	1	5	19	17	4	7	19284	155	5394
410912	경기도	안양시만안구	석수3동	10467	7890	4203	3341	181	3	56	2	1	1	8	8	3	7	7814	76	2577
410913	경기도	안양시만안구	박달1동	12619	9272	4896	4005	180	3	57	1	0	2	13	12	5	6	9180	92	3347
410914	경기도	안양시만안구	박달2동	16550	13030	6675	5811	311	5	89	3	0	4	6	9	4	8	12925	105	3520
411001	경기도	안양시동안구	비산1동	17373	14270	6807	6927	342	0	56	3	3	2	9	4	1	7	14161	109	3103
411002	경기도	안양시동안구	비산2동	11477	9683	4778	4555	238	5	34	2	0	0	8	4	1	3	9628	55	1794
411003	경기도	안양시동안구	비산3동	10205	7659	3793	3574	151	1	60	3	0	1	6	7	1	7	7604	55	2546
411004	경기도	안양시동안구	부흥동	13348	11167	5547	5149	308	4	43	1	1	2	11	6	3	3	11078	89	2181
411005	경기도	안양시동안구	달안동	9513	7618	3710	3555	222	3	43	1	2	2	8	6	1	4	7557	61	1895
411006	경기도	안양시동안구	관양1동	27373	20661	10060	9788	474	7	116	6	4	0	25	12	4	8	20504	157	6712
411007	경기도	안양시동안구	관양2동	15026	11589	5599	5490	315	6	67	2	1	3	9	7	7	3	11509	80	3437
411008	경기도	안양시동안구	부림동	19625	15490	7924	6937	417	3	61	2	1	4	6	6	1	2	15364	126	4135
411009	경기도	안양시동안구	평촌동	11131	9386	4550	4451	272	3	38	2	1	2	5	6	1	0	9331	55	1745
411010	경기도	안양시동안구	평안동	16474	13847	7032	6266	396	2	43	2	1	2	4	7	3	1	13759	88	2627
411011	경기도	안양시동안구	귀인동	11241	9483	4382	4776	215	5	28	1	2	0	4	1	2	7	9423	60	1758
411012	경기도	안양시동안구	호계1동	13413	11213	5386	5397	298	2	43	3	1	2	3	5	0	1	11141	72	2200
411013	경기도	안양시동안구	호계2동	14079	11136	5330	5332	290	5	53	2	3	6	8	11	1	4	11045	91	2943
411014	경기도	안양시동안구	호계3동	17356	13798	6803	6460	329	3	70	3	2	3	11	3	2	2	13691	107	3558
411015	경기도	안양시동안구	범계동	12562	10611	4675	5493	329	3	29	2	0	2	3	6	3	2	10547	64	1951
411016	경기도	안양시동안구	신촌동	10232	8631	4119	4176	218	4	38	2	1	1	6	0	2	3	8570	61	1601
411017	경기도	안양시동안구	갈산동	8147	6604	2899	3459	148	2	33	4	0	5	4	5	1	4	6564	40	1543
411402	경기도	광명시	광명1동	0	0	0	0	0	0	0	0	0	0	0	0	0	0	0	0	0
411402	경기도	광명시	광명2동	3507	2531	1312	1125	48	1	20	2	1	1	1	1	1	0	2513	18	976
411403	경기도	광명시	광명3동	8339	6000	3096	2689	113	4	47	1	1	1	8	3	1	5	5969	31	2339
411404	경기도	광명시	광명4동	11222	8509	4280	3875	193	6	67	1	2	2	11	4	1	3	8445	64	2713
411405	경기도	광명시	광명5동	10163	7562	3884	3396	153	3	45	1	0	0	10	6	1	5	7504	58	2601
411406	경기도	광명시	광명6동	8422	6645	3358	3049	136	3	39	2	2	2	10	4	1	1	6607	38	1777
411407	경기도	광명시	광명7동	16160	12236	6338	5426	264	7	76	4	1	0	10	10	3	1	12140	96	3924
411408	경기도	광명시	철산1동	8239	6773	3659	2840	166	11	31	2	1	1	4	5	2	0	6722	51	1466
411409	경기도	광명시	철산2동	4852	3442	1775	1520	78	4	31	1	0	1	3	3	1	2	3419	23	1410
411410	경기도	광명시	철산3동	25082	20782	10002	9944	533	11	89	7	0	4	20	5	3	7	20625	157	4300
411411	경기도	광명시	철산4동	11043	8899	4965	3540	238	4	51	2	0	1	10	6	2	6	8825	74	2144
411412	경기도	광명시	하안1동	18878	15150	7765	6827	361	1	70	3	1	2	8	7	2	2	15049	101	3728
411413	경기도	광명시	하안2동	11211	8765	4669	3728	235	2	40	3	3	1	5	5	3	2	8696	69	2446
411414	경기도	광명시	하안3동	16124	12684	6738	5472	267	4	58	4	1	3	10	9	4	4	12574	110	3440
411415	경기도	광명시	하안4동	10414	8584	4695	3509	248	3	44	1	1	3	5	4	2	2	8517	67	1830
411416	경기도	광명시	소하1동	23130	18485	10237	7541	432	7	82	6	0	6	7	14	8	7	18347	138	4645
411417	경기도	광명시	소하2동	22370	17222	9353	7136	429	4	112	1	2	1	13	21	6	10	17088	134	5148
411418	경기도	광명시	학온동	2109	1702	663	990	25	1	11	1	0	0	3	0	2	2	1698	4	407
411419	경기도	광명시	일직동	15021	12012	5784	5775	324	5	38	1	1	0	5	7	2	1	11943	69	3009
411501	경기도	평택시	팽성읍	23756	15437	6656	8150	253	9	195	4	0	4	12	18	5	8	15314	123	8319
411502	경기도	평택시	안중읍	31733	21949	11791	9095	571	10	252	5	1	5	22	49	5	6	21812	137	9784
411503	경기도	평택시	포승읍	19057	12413	6391	5441	251	3	178	6	3	1	7	29	3	11	12324	89	6644
411504	경기도	평택시	진위면	9426	6369	2984	3081	151	5	79	2	2	1	4	13	3	6	6331	38	3057
411505	경기도	평택시	서탄면	3151	2297	909	1282	45	0	36	1	2	0	2	3	1	2	2283	14	854
411506	경기도	평택시	고덕면	10523	7195	3280	3574	169	1	85	1	2	1	8	26	1	1	7149	46	3328
411507	경기도	평택시	오성면	6132	4461	1892	2362	105	1	51	2	0	1	8	6	3	1	4432	29	1671
411509	경기도	평택시	현덕면	5580	4365	1928	2276	75	3	38	1	0	1	4	7	4	3	4340	25	1215
411510	경기도	평택시	중앙동	34708	24041	11607	11209	597	15	274	9	2	8	13	47	6	11	23798	243	10667
411511	경기도	평택시	서정동	21144	13368	6503	6205	260	6	187	4	1	3	17	16	3	10	13215	153	7776
411512	경기도	평택시	송탄동	16434	11661	6051	5083	287	3	125	1	2	1	6	11	5	7	11582	79	4773
411513	경기도	평택시	지산동	11490	7211	3568	3271	151	3	114	4	1	2	2	9	1	2	7128	83	4279
411514	경기도	평택시	송북동	17922	12368	5813	5977	309	7	139	2	0	2	6	12	1	7	12275	93	5554
411515	경기도	평택시	신장1동	5858	3716	1723	1777	95	5	58	3	0	2	3	3	0	1	3670	46	2142
411516	경기도	평택시	신장2동	5430	3235	1395	1684	64	1	50	0	0	1	3	10	2	0	3210	25	2195
411517	경기도	평택시	신평동	18456	11849	5187	6123	259	2	131	10	2	5	8	19	6	6	11758	91	6607
411518	경기도	평택시	원평동	11659	8294	3827	4040	222	8	96	1	3	2	5	10	2	4	8220	74	3365
411519	경기도	평택시	통복동	5211	4022	1803	2029	89	2	41	1	1	3	1	6	1	1	3978	44	1189
411520	경기도	평택시	비전1동	36548	26469	13770	11525	672	12	234	6	3	2	13	46	2	4	26289	180	10079
411521	경기도	평택시	비전2동	40673	29554	14212	14040	747	15	215	6	4	2	26	47	6	12	29332	222	11119
411522	경기도	평택시	세교동	22197	15678	7680	7318	346	3	144	5	2	4	7	34	6	4	15553	125	6519
411523	경기도	평택시	청북읍	18636	12947	7212	5212	274	5	140	4	1	1	10	19	4	6	12888	59	5689
411524	경기도	평택시	용이동	19405	14473	7838	6054	336	6	128	3	1	2	8	16	0	3	14395	78	4932
411525	경기도	평택시	동삭동	26057	18655	9774	8064	463	5	154	2	2	5	11	20	5	7	18512	143	7402
411526	경기도	평택시	고덕동	15326	11036	5408	5090	296	8	129	5	1	1	5	9	0	2	10954	82	4290
411601	경기도	양주시	백석읍	20638	14414	6963	6812	310	5	158	2	1	5	14	31	6	9	14316	98	6224
411602	경기도	양주시	은현면	5161	3742	1522	2047	52	0	62	1	0	1	2	9	4	4	3704	38	1419
411603	경기도	양주시	남면	5746	3957	1606	2188	72	0	38	0	3	2	4	4	2	9	3928	29	1789
411604	경기도	양주시	광적면	10385	7441	3444	3717	119	6	81	1	0	3	5	7	5	4	7392	49	2944
411605	경기도	양주시	장흥면	8742	6052	2520	3223	119	3	114	1	0	1	8	8	2	0	5999	53	2690
411606	경기도	양주시	양주1동	5222	3976	1834	1973	88	5	32	0	2	1	3	3	2	1	3944	32	1246
411607	경기도	양주시	양주2동	36330	26251	14495	10727	583	8	209	4	1	5	17	29	6	7	26091	160	10079
411608	경기도	양주시	회천1동	8640	6387	3185	2926	118	2	68	2	1	1	4	13	2	2	6324	63	2253
411609	경기도	양주시	회천2동	21485	14894	7999	6171	335	4	150	6	6	1	20	54	3	8	14757	137	6591
411610	경기도	양주시	회천3동	20748	15104	8002	6375	393	11	129	5	1	4	8	29	0	11	14968	136	5644
411611	경기도	양주시	회천4동	36675	26056	14674	10348	556	7	205	5	1	4	18	55	3	6	25882	174	10619
411701	경기도	동두천시	생연1동	5784	3830	1839	1842	57	1	55	1	0	0	1	7	4	2	3809	21	1954
411702	경기도	동두천시	생연2동	9425	6635	3312	3025	128	3	77	3	2	5	7	13	2	5	6582	53	2790
411703	경기도	동두천시	중앙동	4793	3229	1452	1666	40	1	40	0	2	2	1	6	1	2	3213	16	1564
411704	경기도	동두천시	보산동	2683	1814	826	905	33	1	25	0	0	2	5	2	2	0	1801	13	869
411705	경기도	동두천시	불현동	19837	13098	6505	6025	251	4	137	5	1	1	16	24	6	8	12983	115	6739
411706	경기도	동두천시	송내동	20407	14618	7694	6353	300	6	115	2	1	6	11	20	3	6	14517	101	5789
411707	경기도	동두천시	소요동	7514	5174	2367	2576	101	3	44	3	1	3	11	12	3	2	5126	48	2340
411708	경기도	동두천시	상패동	4722	3346	1564	1611	72	1	51	0	2	0	8	3	2	1	3315	31	1376
411801	경기도	안산시상록구	일동	20022	13515	8000	4933	269	16	124	7	1	5	5	25	3	7	13395	120	6507
411802	경기도	안산시상록구	이동	19182	12350	6692	5072	277	12	144	3	3	3	11	13	6	4	12240	110	6832
411806	경기도	안산시상록구	본오1동	28883	18606	10931	6815	400	10	193	4	4	5	9	20	5	12	18408	198	10277
411807	경기도	안산시상록구	본오2동	21077	15047	8392	5967	353	10	141	0	3	4	13	18	5	10	14916	131	6030
411808	경기도	안산시상록구	본오3동	17387	12874	6943	5370	288	13	113	4	1	1	15	13	5	7	12773	101	4513
411809	경기도	안산시상록구	부곡동	17557	12038	6889	4621	265	8	117	4	4	1	12	12	0	8	11941	97	5519
411810	경기도	안산시상록구	월피동	29764	20209	11397	7894	450	20	210	6	0	7	16	22	9	11	20042	167	9555
411811	경기도	안산시상록구	성포동	21088	16644	8435	7534	408	6	71	2	5	4	15	18	2	9	16509	135	4444
411812	경기도	안산시상록구	반월동	14352	10980	5505	4998	259	8	96	6	4	2	12	7	2	3	10902	78	3372
411813	경기도	안산시상록구	안산동	7508	5361	2822	2340	94	2	55	2	1	2	6	0	1	5	5330	31	2147
411814	경기도	안산시상록구	사동	28825	20172	11389	7832	475	11	205	8	1	1	10	29	3	8	19972	200	8653
411815	경기도	안산시상록구	사이동	24994	17803	9877	7128	379	14	194	4	3	2	12	20	9	6	17648	155	7191
411816	경기도	안산시상록구	해양동	27258	21482	10684	9977	538	13	93	2	1	2	9	9	0	2	21330	152	5776
411901	경기도	안산시단원구	와동	30273	19042	11198	6875	420	20	277	7	1	4	18	28	4	14	18866	176	11231
411904	경기도	안산시단원구	호수동	33030	26218	13560	11596	641	13	131	5	7	1	10	19	3	9	25995	223	6812
411908	경기도	안산시단원구	초지동	35301	26073	14133	10797	659	17	176	4	1	6	11	15	5	11	25835	238	9228
411909	경기도	안산시단원구	선부1동	15235	11549	6114	4931	262	11	100	3	2	3	7	14	1	4	11452	97	3686
411910	경기도	안산시단원구	선부2동	13337	8831	5012	3401	191	4	104	4	5	1	6	6	3	3	8740	91	4506
411911	경기도	안산시단원구	선부3동	26613	18680	10423	7407	452	9	173	8	4	5	10	21	1	5	18518	162	7933
411912	경기도	안산시단원구	대부동	7226	5240	1938	3140	62	2	48	4	2	2	5	0	2	2	5207	33	1986
411913	경기도	안산시단원구	고잔동	18316	13018	7055	5330	358	12	127	6	0	0	7	11	6	5	12917	101	5298
411914	경기도	안산시단원구	중앙동	19740	14351	7331	6375	354	10	107	2	3	3	13	8	6	5	14217	134	5389
411915	경기도	안산시단원구	원곡동	5185	2970	1686	1190	36	0	28	1	0	1	6	3	0	0	2951	19	2215
411916	경기도	안산시단원구	백운동	17764	13509	7086	5832	328	9	103	1	1	1	13	17	1	2	13394	115	4255
411917	경기도	안산시단원구	신길동	17408	12504	6980	4987	273	5	103	4	3	4	16	16	5	7	12403	101	4904
412001	경기도	고양시덕양구	주교동	12141	8361	4368	3547	282	4	69	3	2	1	8	10	0	4	8298	63	3780
412002	경기도	고양시덕양구	원신동	15963	12123	6316	5185	463	4	62	0	1	8	3	5	0	0	12047	76	3840
412003	경기도	고양시덕양구	흥도동	20025	15605	8357	6339	708	6	80	1	3	4	9	8	2	0	15517	88	4420
412004	경기도	고양시덕양구	성사1동	17973	13230	6742	5856	424	5	75	2	1	8	16	14	3	1	13147	83	4743
412005	경기도	고양시덕양구	성사2동	9208	7152	3638	3172	240	3	49	1	0	1	5	6	0	1	7116	36	2056
412006	경기도	고양시덕양구	효자동	10989	8808	4455	3877	329	5	42	2	2	5	6	14	0	1	8738	70	2181
412008	경기도	고양시덕양구	창릉동	17660	13957	7117	6238	424	2	73	3	2	2	8	5	0	2	13876	81	3703
412009	경기도	고양시덕양구	고양동	22873	16189	8391	6965	568	8	101	2	5	6	9	12	6	7	16080	109	6684
412010	경기도	고양시덕양구	관산동	28856	19216	9910	8270	665	5	183	4	4	4	14	18	6	13	19096	120	9640
412011	경기도	고양시덕양구	능곡동	12477	9438	4470	4564	262	4	58	4	2	1	7	11	1	1	9385	53	3039
412012	경기도	고양시덕양구	화정1동	31877	24765	12010	11562	843	17	112	4	5	6	17	22	2	3	24603	162	7112
412013	경기도	고양시덕양구	화정2동	24146	18899	9853	8171	633	7	67	4	1	1	6	14	3	5	18765	134	5247
412014	경기도	고양시덕양구	행주동	14694	10016	4989	4528	257	2	108	5	0	5	9	26	2	1	9932	84	4678
412015	경기도	고양시덕양구	행신1동	16784	13111	6782	5724	401	11	62	4	3	3	5	16	5	2	13018	93	3673
412016	경기도	고양시덕양구	행신2동	24985	19728	10155	8610	625	9	92	7	1	5	16	30	5	7	19562	166	5257
412017	경기도	고양시덕양구	행신3동	19240	15622	8360	6554	486	5	62	6	3	2	15	16	1	4	15514	108	3618
412018	경기도	고양시덕양구	화전동	18699	14536	7900	6005	402	11	90	5	4	8	11	18	2	1	14457	79	4163
412019	경기도	고양시덕양구	대덕동	1999	1495	707	738	30	1	10	0	0	0	3	1	0	0	1490	5	504
412024	경기도	고양시덕양구	삼송1동	16277	13239	6540	6086	448	4	56	6	4	3	4	8	1	3	13163	76	3038
412025	경기도	고양시덕양구	삼송2동	19716	14870	7533	6612	503	6	78	6	0	4	10	11	2	5	14770	100	4846
412026	경기도	고양시덕양구	행신4동	16172	11914	6571	4763	344	8	92	2	1	3	6	16	0	4	11810	104	4258
412101	경기도	고양시일산동구	식사동	26840	20703	9494	10503	473	3	90	1	1	4	9	6	1	3	20588	115	6137
412103	경기도	고양시일산동구	정발산동	18430	13662	6682	6389	366	8	76	8	1	6	8	8	1	5	13558	104	4768
412104	경기도	고양시일산동구	풍산동	27656	20441	10780	8821	527	11	97	6	3	6	10	16	2	6	20285	156	7215
412105	경기도	고양시일산동구	백석1동	23191	17935	8960	8243	490	9	79	1	1	5	8	9	3	4	17812	123	5256
412106	경기도	고양시일산동구	백석2동	17520	12542	6530	5481	336	7	81	1	1	4	11	5	2	1	12460	82	4978
412107	경기도	고양시일산동구	마두1동	18505	14793	6997	7160	437	7	68	1	0	2	10	3	3	3	14691	102	3712
412108	경기도	고양시일산동구	마두2동	14198	11844	5530	5953	251	5	26	3	0	2	8	6	0	2	11786	58	2354
412109	경기도	고양시일산동구	장항1동	7896	6095	2529	3381	116	0	29	0	0	2	3	5	0	0	6065	30	1801
412110	경기도	고양시일산동구	장항2동	21076	13771	6464	6790	307	3	82	4	1	5	12	8	3	6	13685	86	7305
412111	경기도	고양시일산동구	고봉동	17065	10762	5207	5074	266	6	108	5	1	4	10	8	2	0	10691	71	6303
412113	경기도	고양시일산동구	중산1동	17589	12964	6256	6129	365	8	77	6	0	4	12	11	1	2	12871	93	4625
412114	경기도	고양시일산동구	중산2동	18009	13405	7153	5731	329	8	71	1	0	4	6	11	3	4	13321	84	4604
412201	경기도	고양시일산서구	일산1동	20786	15571	8056	6871	404	12	92	1	2	3	8	21	6	5	15481	90	5215
412202	경기도	고양시일산서구	일산2동	14878	11070	5509	5149	246	5	66	0	1	6	11	15	1	4	11013	57	3808
412203	경기도	고양시일산서구	일산3동	24963	20077	10338	8973	530	11	64	2	2	5	10	9	2	5	19951	126	4886
412205	경기도	고양시일산서구	주엽1동	21604	17048	8147	8294	391	7	60	3	2	4	8	4	5	3	16928	120	4556
412206	경기도	고양시일산서구	주엽2동	21885	17116	8110	8329	438	9	67	4	1	6	22	6	1	8	17001	115	4769
412207	경기도	고양시일산서구	대화동	28571	21266	10441	9883	578	9	106	10	2	10	18	26	2	9	21094	172	7305
412208	경기도	고양시일산서구	송포동	16103	12597	5959	6200	298	6	50	1	0	1	6	5	1	4	12531	66	3506
412210	경기도	고양시일산서구	탄현1동	24641	18551	9811	7964	496	11	101	4	2	4	11	14	3	9	18430	121	6090
412211	경기도	고양시일산서구	탄현2동	14287	10927	5977	4494	283	5	72	5	0	1	5	12	3	1	10858	69	3360
412212	경기도	고양시일산서구	덕이동	22419	15988	8116	7296	338	6	111	2	0	4	14	9	2	4	15902	86	6431
412213	경기도	고양시일산서구	가좌동	14822	11471	5699	5327	312	6	52	4	3	1	5	3	2	0	11414	57	3351
412301	경기도	과천시	중앙동	8449	7174	2422	4502	167	1	14	0	1	6	4	3	0	2	7122	52	1275
412302	경기도	과천시	갈현동	11905	10079	3819	5892	237	4	36	2	3	5	9	3	2	0	10012	67	1826
412303	경기도	과천시	별양동	12149	10240	3733	6114	244	6	45	4	1	2	2	6	3	0	10160	80	1909
412304	경기도	과천시	부림동	11435	9637	3682	5573	245	3	34	5	1	3	4	8	0	2	9560	77	1798
412305	경기도	과천시	과천동	6702	5099	2077	2828	104	6	31	5	1	0	4	3	1	1	5061	38	1603
412306	경기도	과천시	문원동	5784	4751	2225	2312	124	5	26	1	3	3	4	2	1	3	4709	42	1033
412401	경기도	의왕시	고천동	12052	9558	4529	4612	238	5	69	7	2	2	7	15	0	3	9489	69	2494
412402	경기도	의왕시	부곡동	22988	17412	9023	7629	413	12	136	5	8	2	13	8	4	9	17262	150	5576
412403	경기도	의왕시	오전동	28791	22384	11003	10542	491	9	118	4	4	2	27	17	4	7	22228	156	6407
412404	경기도	의왕시	내손1동	15120	12073	5451	6138	309	4	61	3	4	2	8	9	1	2	11992	81	3047
412405	경기도	의왕시	내손2동	17007	13752	6561	6696	327	4	48	5	1	2	5	3	3	3	13658	94	3255
412406	경기도	의왕시	청계동	26525	20961	9654	10503	508	11	105	3	1	4	15	15	3	4	20826	135	5564
412501	경기도	구리시	갈매동	21819	16821	9096	7139	356	5	79	3	0	1	13	13	3	5	16713	108	4998
412502	경기도	구리시	동구동	28669	22620	11221	10444	585	1	121	4	5	8	22	20	4	11	22446	174	6049
412503	경기도	구리시	인창동	18101	13921	6932	6431	312	8	98	4	2	2	14	10	4	6	13823	98	4180
412504	경기도	구리시	교문1동	13748	9403	4406	4629	198	4	74	1	1	3	9	8	1	5	9339	64	4345
412505	경기도	구리시	교문2동	15535	12338	5692	6149	320	4	60	1	1	2	8	6	3	4	12250	88	3197
412506	경기도	구리시	수택1동	13699	9764	4713	4649	200	4	82	3	2	0	11	9	0	1	9674	90	3935
412507	경기도	구리시	수택2동	19831	14031	6965	6464	312	4	142	2	2	4	14	18	5	7	13939	92	5800
412508	경기도	구리시	수택3동	18289	14444	6975	6887	380	3	69	4	2	6	11	4	1	4	14346	98	3845
412601	경기도	남양주시	와부읍	46311	36730	17621	17715	841	6	192	13	5	12	28	31	9	14	36487	243	9581
412602	경기도	남양주시	진접읍	69463	48653	26248	20587	949	23	398	8	7	13	35	43	9	13	48333	320	20810
412603	경기도	남양주시	화도읍	88430	59963	32482	25135	1243	17	549	11	6	10	36	50	12	22	59573	390	28467
412604	경기도	남양주시	진건읍	19561	14132	6684	6871	294	8	110	5	2	7	9	15	6	3	14014	118	5429
412605	경기도	남양주시	오남읍	41590	28769	16082	11582	632	11	235	7	3	2	24	22	4	9	28613	156	12821
412606	경기도	남양주시	별내면	16117	12205	6493	5255	251	7	70	2	2	4	13	9	2	2	12110	95	3912
412608	경기도	남양주시	수동면	8421	6299	2837	3192	117	4	48	4	5	2	6	4	3	9	6231	68	2122
412609	경기도	남양주시	조안면	3271	2492	933	1462	50	0	20	1	0	0	7	4	2	0	2479	13	779
412610	경기도	남양주시	호평동	42438	32132	17359	13607	693	8	203	5	3	7	16	24	7	8	31940	192	10306
412611	경기도	남양주시	평내동	27175	20369	11318	8314	432	10	120	2	1	6	22	5	2	4	20236	133	6806
412612	경기도	남양주시	금곡동	16617	12062	5629	5929	262	2	106	1	3	2	13	13	4	8	11972	90	4555
412613	경기도	남양주시	양정동	4225	3348	1446	1795	51	0	29	0	0	1	1	1	1	0	3325	23	877
412616	경기도	남양주시	별내동	56945	42552	21856	19078	966	20	244	8	6	10	26	25	13	11	42263	289	14393
412617	경기도	남양주시	다산1동	62579	47964	24224	21875	1199	12	257	9	4	9	35	29	8	10	47671	293	14615
412618	경기도	남양주시	다산2동	26335	20930	10529	9647	484	4	86	4	0	2	6	23	2	3	20790	140	5405
412619	경기도	남양주시	퇴계원읍	23419	17490	8751	8026	367	7	136	7	2	5	23	13	4	6	17347	143	5929
412701	경기도	오산시	중앙동	27123	20145	10740	8524	503	6	162	3	1	2	12	12	7	7	19979	166	6978
412702	경기도	오산시	대원동	47868	32788	17579	13650	842	16	331	7	2	3	24	32	5	18	32509	279	15080
412703	경기도	오산시	남촌동	18141	9648	5164	3946	205	5	188	2	1	1	5	11	1	6	9535	113	8493
412704	경기도	오산시	신장동	42362	29348	16084	11973	705	13	280	11	2	6	14	31	3	11	29133	215	13014
412705	경기도	오산시	세마동	23856	18280	9739	7726	481	6	153	6	3	2	8	19	2	6	18151	129	5576
412706	경기도	오산시	초평동	12833	8966	4964	3553	225	7	112	3	0	0	7	10	2	3	8886	80	3867
412801	경기도	화성시	봉담읍	60174	43807	24200	17640	1102	16	436	11	4	9	24	37	9	22	43510	297	16367
412802	경기도	화성시	우정읍	14523	10300	4975	4847	239	5	102	5	2	7	7	17	7	5	10218	82	4223
412803	경기도	화성시	향남읍	61719	41940	23936	16231	938	19	404	7	3	4	20	51	14	13	41640	300	19779
412804	경기도	화성시	매송면	5976	4405	1873	2368	63	2	51	0	0	1	8	2	1	1	4370	35	1571
412805	경기도	화성시	비봉면	5803	4298	1785	2359	75	0	36	1	0	1	1	10	1	0	4269	29	1505
412806	경기도	화성시	마도면	6466	4597	2047	2368	66	2	56	2	1	2	2	4	1	1	4552	45	1869
412807	경기도	화성시	송산면	9203	6539	2471	3803	125	1	56	0	0	0	10	9	4	2	6481	58	2664
412808	경기도	화성시	서신면	6192	4350	1734	2463	62	1	43	2	1	1	10	6	2	0	4325	25	1842
412809	경기도	화성시	팔탄면	10244	7603	3628	3717	130	0	68	2	1	1	2	7	1	6	7563	40	2641
412810	경기도	화성시	장안면	8204	5357	2396	2728	106	4	67	2	1	0	2	6	3	3	5318	39	2847
412811	경기도	화성시	양감면	4709	3702	1701	1874	61	3	34	1	1	2	2	2	2	0	3683	19	1007
412812	경기도	화성시	정남면	9809	6993	3048	3644	131	4	92	4	1	1	4	7	4	6	6946	47	2816
412814	경기도	화성시	남양읍	31571	21817	11079	9755	511	7	236	8	3	4	7	13	5	9	21637	180	9754
412815	경기도	화성시	진안동	30857	21163	11045	9199	463	7	188	5	2	3	11	22	6	11	20962	201	9694
412816	경기도	화성시	병점1동	27125	20502	10839	8745	515	5	152	0	1	1	11	18	0	3	20290	212	6623
412817	경기도	화성시	병점2동	18222	13996	8054	5328	360	3	106	5	1	1	7	11	5	4	13885	111	4226
412818	경기도	화성시	반월동	21646	16931	8898	7373	420	4	90	0	1	0	9	6	4	5	16810	121	4715
412819	경기도	화성시	기배동	12241	9790	5487	3878	272	7	75	0	2	1	5	6	1	6	9740	50	2451
412820	경기도	화성시	화산동	18277	13109	6894	5680	276	3	128	5	1	1	7	8	2	4	13009	100	5168
412821	경기도	화성시	동탄1동	34329	26864	13442	12390	658	6	117	4	1	5	0	11	4	6	26644	220	7465
412822	경기도	화성시	동탄2동	24438	19819	10993	8096	489	6	80	6	3	4	8	11	2	5	19703	116	4619
412823	경기도	화성시	동탄3동	31190	24454	13792	9649	652	12	129	4	3	2	8	6	8	5	24270	184	6736
412824	경기도	화성시	동탄4동	35181	29529	15454	13054	741	1	84	0	1	1	4	25	2	4	29371	158	5652
412825	경기도	화성시	새솔동	16707	13049	7339	5242	316	5	72	2	4	0	1	5	1	2	12989	60	3658
412826	경기도	화성시	동탄5동	32099	24928	12981	10909	672	14	138	4	1	4	5	8	6	5	24747	181	7171
412827	경기도	화성시	동탄6동	26072	19490	9650	9039	506	9	96	0	1	6	3	10	0	1	19321	169	6582
412828	경기도	화성시	동탄7동	54776	42054	22408	18084	1048	11	192	5	4	8	13	18	5	4	41800	254	12722
412829	경기도	화성시	동탄8동	22183	17650	9747	7166	498	3	85	1	2	4	6	14	2	2	17530	120	4533
412901	경기도	시흥시	대야동	35084	26230	13820	11307	629	10	177	5	5	6	24	25	6	10	26024	206	8854
412902	경기도	시흥시	신천동	29385	20119	10924	8309	442	7	195	4	1	2	19	19	9	12	19943	176	9266
412903	경기도	시흥시	신현동	8825	6770	3377	3120	132	4	63	1	0	0	3	9	1	4	6714	56	2055
412904	경기도	시흥시	은행동	40263	31078	17950	11836	780	11	233	3	3	3	15	25	2	9	30870	208	9185
412905	경기도	시흥시	매화동	10308	7579	4193	3117	111	6	64	3	2	0	12	8	1	5	7522	57	2729
412906	경기도	시흥시	목감동	30260	23120	12955	9289	514	12	138	2	6	6	12	20	1	8	22963	157	7140
412907	경기도	시흥시	군자동	17207	11620	6505	4579	243	10	132	2	3	5	15	14	6	9	11523	97	5587
412908	경기도	시흥시	정왕본동	17355	9845	5689	3711	185	13	149	0	0	4	10	5	0	4	9770	75	7510
412909	경기도	시흥시	정왕1동	18501	11426	6694	4242	225	5	132	2	3	0	12	12	3	6	11336	90	7075
412910	경기도	시흥시	정왕2동	24577	16674	9858	6109	386	10	150	3	3	2	12	17	3	10	16563	111	7903
412911	경기도	시흥시	정왕3동	19660	13675	8113	5027	274	7	125	3	1	2	8	11	3	9	13583	92	5985
412912	경기도	시흥시	정왕4동	16116	12288	7223	4572	276	4	96	2	3	0	7	10	1	4	12198	90	3828
412913	경기도	시흥시	과림동	1973	1598	679	874	22	0	7	0	0	0	3	2	0	0	1587	11	375
412914	경기도	시흥시	연성동	18361	13994	8075	5345	357	2	80	1	2	2	13	12	3	4	13896	98	4367
412915	경기도	시흥시	능곡동	18442	14134	7697	5911	312	4	84	2	1	4	7	15	4	1	14042	92	4308
412916	경기도	시흥시	월곶동	13087	9318	5152	3825	166	6	89	1	4	2	9	11	1	1	9267	51	3769
412917	경기도	시흥시	장곡동	23013	17320	9906	6763	420	9	95	1	4	2	5	13	5	8	17231	89	5693
412919	경기도	시흥시	배곧1동	24075	18851	11396	6789	423	4	117	0	2	2	10	8	2	11	18764	87	5224
412920	경기도	시흥시	배곧2동	24510	18279	10452	7156	378	8	137	0	2	1	5	8	0	5	18152	127	6231
413001	경기도	군포시	군포1동	25643	18383	9263	8306	429	16	169	2	4	5	11	12	0	8	18225	158	7260
413002	경기도	군포시	군포2동	34189	27138	14440	11559	691	4	147	11	1	5	18	13	5	7	26901	237	7051
413003	경기도	군포시	산본1동	13061	9499	4683	4391	227	8	69	2	3	5	9	6	3	4	9410	89	3562
413004	경기도	군포시	산본2동	19871	16110	7675	7820	385	9	76	2	1	7	6	6	2	4	15993	117	3761
413005	경기도	군포시	금정동	15067	10863	5696	4694	242	3	101	4	3	3	12	6	3	3	10770	93	4204
413006	경기도	군포시	재궁동	16633	12987	6799	5603	334	6	86	1	0	3	11	11	3	3	12860	127	3646
413007	경기도	군포시	오금동	16335	13121	6923	5654	337	6	62	3	2	3	7	7	3	3	13010	111	3214
413008	경기도	군포시	수리동	12862	10216	5166	4624	270	1	53	7	0	2	7	7	3	3	10143	73	2646
413009	경기도	군포시	궁내동	14861	12230	6359	5389	332	2	47	0	2	2	7	8	2	3	12153	77	2631
413010	경기도	군포시	광정동	18629	14607	7287	6721	356	8	76	3	5	4	7	5	2	5	14479	128	4022
413011	경기도	군포시	대야동	7943	6463	3544	2658	147	5	46	1	0	0	9	5	2	1	6418	45	1480
413012	경기도	군포시	송부동	14815	11832	6591	4740	309	1	80	3	0	2	7	11	1	3	11748	84	2983
413101	경기도	하남시	천현동	6158	4366	1755	2493	56	2	26	0	0	1	4	3	0	0	4340	26	1792
413102	경기도	하남시	신장1동	7606	5842	2834	2792	100	2	52	1	4	3	6	9	5	1	5809	33	1764
413103	경기도	하남시	신장2동	34707	26393	11836	13681	520	11	124	3	3	5	14	16	2	9	26224	169	8314
413104	경기도	하남시	덕풍1동	12444	9351	4510	4506	179	2	53	3	1	3	7	15	3	2	9284	67	3093
413105	경기도	하남시	덕풍2동	15599	11340	5415	5512	224	7	79	3	0	0	10	12	3	3	11268	72	4259
413106	경기도	하남시	덕풍3동	19525	14730	7021	7188	329	5	74	1	1	2	14	9	3	4	14651	79	4795
413107	경기도	하남시	풍산동	18834	14587	7384	6705	326	3	53	2	3	2	2	7	3	3	14493	94	4247
413108	경기도	하남시	감북동	2670	2117	897	1138	52	1	11	0	0	1	1	2	1	0	2104	13	553
413109	경기도	하남시	춘궁동	3574	2752	1020	1658	43	0	15	0	0	1	2	5	1	1	2746	6	822
413110	경기도	하남시	초이동	2931	2145	905	1171	36	0	15	0	0	0	2	0	0	0	2129	16	786
413111	경기도	하남시	미사1동	38018	27534	13975	12398	741	8	138	6	4	6	14	12	6	4	27312	222	10484
413112	경기도	하남시	미사2동	33056	25920	13427	11604	584	11	88	10	4	3	15	18	5	4	25773	147	7136
413113	경기도	하남시	위례동	17810	14331	5899	7974	325	4	36	1	3	0	5	1	1	0	14249	82	3479
413114	경기도	하남시	감일동	20315	16033	8383	7023	406	2	78	2	0	3	8	17	2	4	15928	105	4282
413201	경기도	파주시	문산읍	36465	24748	12566	11038	551	10	280	8	3	14	18	34	13	14	24549	199	11717
413202	경기도	파주시	조리읍	23799	16927	8414	7838	352	4	146	5	3	5	11	18	4	3	16803	124	6872
413203	경기도	파주시	법원읍	9134	6389	2715	3328	146	3	84	4	1	2	7	13	5	5	6313	76	2745
413204	경기도	파주시	파주읍	11569	7807	3532	3899	159	10	108	2	1	1	5	5	4	7	7733	74	3762
413205	경기도	파주시	광탄면	9892	6996	2943	3735	172	5	68	1	0	3	9	6	1	2	6945	51	2896
413206	경기도	파주시	탄현면	11461	8250	4126	3777	181	9	69	2	2	2	5	8	2	6	8189	61	3211
413207	경기도	파주시	월롱면	8968	6135	2782	3043	132	3	83	1	2	1	4	5	2	6	6064	71	2833
413208	경기도	파주시	적성면	5950	4291	1590	2491	83	2	45	1	2	1	2	7	5	3	4232	59	1659
413209	경기도	파주시	파평면	3763	2829	1134	1547	83	1	29	1	1	1	2	3	4	4	2810	19	934
413212	경기도	파주시	교하동	36293	26370	14544	10767	637	8	181	16	0	4	16	28	4	6	26211	159	9923
413213	경기도	파주시	운정1동	42425	32689	18600	12761	783	15	226	11	2	11	27	30	5	9	32480	209	9736
413214	경기도	파주시	운정2동	40922	30757	17748	11746	824	9	168	7	5	7	19	13	2	5	30553	204	10165
413215	경기도	파주시	운정3동	59473	42241	23701	16884	1005	14	256	9	3	13	27	41	6	12	41971	270	17232
413216	경기도	파주시	금촌1동	18839	12084	5897	5602	284	8	140	7	2	2	7	15	3	4	11971	113	6755
413217	경기도	파주시	금촌2동	26231	19858	11052	7891	546	19	155	5	4	4	14	21	4	9	19724	134	6373
413218	경기도	파주시	금촌3동	21466	15065	8018	6322	365	12	163	6	3	5	13	14	8	8	14937	128	6401
413219	경기도	파주시	장단면	799	707	303	364	15	0	12	1	0	0	1	1	0	1	698	9	92
413302	경기도	여주시	점동면	4528	3494	1309	2067	43	3	23	3	1	1	2	3	3	3	3461	33	1034
413303	경기도	여주시	가남읍	12068	8275	3714	4211	155	1	105	1	1	3	6	11	8	3	8219	56	3793
413305	경기도	여주시	흥천면	3965	2890	1002	1773	42	1	34	0	0	0	6	3	2	1	2864	26	1075
413306	경기도	여주시	금사면	2415	1865	541	1265	20	2	10	1	1	0	1	0	1	0	1842	23	550
413307	경기도	여주시	산북면	2091	1634	615	956	29	0	15	0	0	2	0	3	3	4	1627	7	457
413308	경기도	여주시	대신면	5705	4243	1440	2633	65	2	48	0	0	0	9	3	6	6	4212	31	1462
413309	경기도	여주시	북내면	4055	2992	1104	1774	50	0	29	2	0	0	3	3	2	2	2969	23	1063
413310	경기도	여주시	강천면	3732	2772	1104	1549	63	3	25	2	0	0	1	3	0	1	2751	21	960
413311	경기도	여주시	여흥동	17065	11834	5190	6132	242	10	118	2	1	3	10	18	4	8	11738	96	5231
413312	경기도	여주시	중앙동	14535	10162	4551	5120	256	5	108	2	1	4	12	16	4	3	10082	80	4373
413313	경기도	여주시	오학동	14203	10131	4977	4727	224	6	92	3	2	1	13	9	3	6	10063	68	4072
413314	경기도	여주시	세종대왕면	5125	3785	1373	2257	68	0	28	0	0	0	5	7	0	5	3743	42	1340
413401	경기도	이천시	장호원읍	11391	8154	3409	4419	160	7	61	0	0	5	2	4	7	2	8076	78	3237
413402	경기도	이천시	부발읍	26347	18347	9295	8281	387	8	166	1	2	2	9	20	6	13	18190	157	8000
413403	경기도	이천시	신둔면	11437	8360	3917	4110	178	1	65	1	2	3	13	8	1	1	8300	60	3077
413404	경기도	이천시	백사면	8872	6125	2748	3123	120	2	61	2	4	1	6	6	2	4	6079	46	2747
413405	경기도	이천시	호법면	4954	3598	1363	2088	70	1	33	1	0	0	1	6	5	1	3569	29	1356
413406	경기도	이천시	마장면	11838	8456	3716	4295	201	7	118	2	0	1	4	5	5	0	8354	102	3382
413407	경기도	이천시	대월면	12334	8661	4322	3927	196	3	99	4	0	2	4	9	2	4	8572	89	3673
413408	경기도	이천시	모가면	4162	3208	1123	1977	45	0	26	0	1	1	3	2	0	2	3180	28	954
413409	경기도	이천시	설성면	3750	2733	936	1693	45	3	25	0	0	2	2	2	1	1	2710	23	1017
413410	경기도	이천시	율면	2409	1810	719	1018	34	1	13	0	0	2	1	1	1	1	1791	19	599
413411	경기도	이천시	창전동	15588	10796	4707	5593	236	8	106	6	2	2	8	19	3	4	10694	102	4792
413412	경기도	이천시	증포동	37097	26200	13856	11263	599	13	222	8	1	1	10	29	5	6	26013	187	10897
413413	경기도	이천시	중리동	12243	8551	3339	4821	170	1	97	2	1	4	5	14	1	4	8459	92	3692
413414	경기도	이천시	관고동	9674	6956	3070	3606	147	2	65	0	0	2	2	9	3	3	6909	47	2718
413501	경기도	용인시처인구	포곡읍	26527	18716	9956	7873	429	5	206	8	2	3	17	23	2	10	18534	182	7811
413505	경기도	용인시처인구	원삼면	6564	4915	1796	2926	97	4	37	3	3	1	2	1	1	2	4873	42	1649
413506	경기도	용인시처인구	백암면	7413	5135	1941	2959	106	5	44	1	3	4	4	1	8	5	5081	54	2278
413507	경기도	용인시처인구	양지면	15088	10294	4724	5173	193	4	109	0	0	1	5	9	4	3	10225	69	4794
413508	경기도	용인시처인구	중앙동	19697	13735	6423	6659	355	9	135	1	2	2	4	26	5	3	13624	111	5962
413510	경기도	용인시처인구	유림동	26658	18393	9953	7618	426	6	186	5	1	3	10	21	7	14	18250	143	8265
413511	경기도	용인시처인구	동부동	11591	8521	4055	4093	199	7	86	0	1	2	8	11	2	3	8467	54	3070
413512	경기도	용인시처인구	모현읍	20126	14028	7077	6411	273	8	114	1	4	7	7	10	7	3	13922	106	6098
413513	경기도	용인시처인구	이동읍	16403	11225	5575	5183	210	3	135	2	1	3	6	9	4	7	11138	87	5178
413514	경기도	용인시처인구	남사읍	15875	11766	5784	5601	209	2	67	2	2	4	18	6	2	3	11700	66	4109
413515	경기도	용인시처인구	역북동	24299	17799	8954	8004	489	9	149	4	3	8	12	13	2	5	17652	147	6500
413516	경기도	용인시처인구	삼가동	9586	7325	3619	3445	159	0	40	1	2	2	4	9	1	2	7284	41	2261
413601	경기도	용인시수지구	풍덕천1동	29379	23303	10876	11512	548	10	97	3	3	8	16	16	2	6	23097	206	6076
413602	경기도	용인시수지구	풍덕천2동	27836	22446	10953	10657	576	7	59	1	2	4	11	5	3	5	22283	163	5390
413603	경기도	용인시수지구	신봉동	28003	22718	9925	12127	406	5	80	3	3	11	17	4	3	6	22590	128	5285
413604	경기도	용인시수지구	죽전1동	21814	17614	8205	8887	335	5	51	2	0	4	11	10	0	5	17515	99	4200
413605	경기도	용인시수지구	죽전2동	12983	10253	4661	5237	245	3	24	1	3	1	9	4	1	1	10190	63	2730
413606	경기도	용인시수지구	동천동	35443	28864	13127	14792	633	5	78	6	3	9	16	15	1	6	28691	173	6579
413607	경기도	용인시수지구	상현1동	15166	12484	5629	6451	261	6	38	1	5	2	5	6	1	2	12407	77	2682
413608	경기도	용인시수지구	상현2동	24599	20236	9340	10288	381	4	81	3	2	2	11	5	1	4	20122	114	4363
413609	경기도	용인시수지구	성복동	38699	31215	11073	19320	523	5	72	1	4	17	25	8	3	5	31056	159	7484
413610	경기도	용인시수지구	죽전3동	17842	13663	6463	6660	337	5	51	1	2	6	9	14	2	2	13552	111	4179
413611	경기도	용인시수지구	상현3동	18802	14936	6858	7531	352	4	51	2	4	5	6	2	3	3	14821	115	3866
413701	경기도	용인시기흥구	신갈동	31087	24338	12404	10898	621	10	155	3	0	6	12	20	4	7	24140	198	6749
413703	경기도	용인시기흥구	구갈동	29374	22230	10876	10445	560	7	126	2	1	6	7	12	3	6	22051	179	7144
413704	경기도	용인시기흥구	상갈동	10886	8432	4471	3607	217	4	54	0	1	1	5	7	2	4	8373	59	2454
413705	경기도	용인시기흥구	기흥동	15401	10952	5121	5457	212	4	70	2	4	4	14	4	1	5	10898	54	4449
413706	경기도	용인시기흥구	서농동	18396	14317	7132	6602	343	3	70	1	2	1	6	8	2	6	14176	141	4079
413707	경기도	용인시기흥구	구성동	30386	23800	10998	12100	421	7	106	3	2	6	11	17	3	3	23677	123	6586
413708	경기도	용인시기흥구	마북동	24323	19389	8275	10538	341	7	88	1	0	3	10	9	3	2	19277	112	4934
413710	경기도	용인시기흥구	상하동	18410	14158	7274	6372	302	3	78	4	0	11	11	9	3	5	14072	86	4252
413711	경기도	용인시기흥구	보정동	24880	19625	8224	10788	387	4	74	2	3	4	13	3	6	7	19515	110	5255
413715	경기도	용인시기흥구	영덕1동	21126	16450	8499	7394	374	3	61	0	1	6	8	3	2	3	16354	96	4676
413716	경기도	용인시기흥구	영덕2동	12957	10129	5129	4619	232	3	64	2	0	5	2	6	1	4	10067	62	2828
413717	경기도	용인시기흥구	보라동	24875	19275	10040	8626	350	9	94	5	3	6	7	7	1	4	19152	123	5600
413718	경기도	용인시기흥구	동백1동	22888	18163	10431	7082	432	7	75	3	6	4	12	19	1	1	18073	90	4725
413719	경기도	용인시기흥구	동백2동	19816	15915	8339	7079	314	3	64	1	4	1	7	17	0	2	15831	84	3901
413720	경기도	용인시기흥구	동백3동	17737	13865	6589	6860	270	4	43	1	0	3	15	5	1	1	13792	73	3872
413801	경기도	안성시	공도읍	43183	28526	15602	11563	693	12	291	6	3	11	14	36	5	9	28245	281	14657
413802	경기도	안성시	보개면	5186	4054	1698	2164	88	2	32	0	3	1	2	7	0	5	4002	52	1132
413803	경기도	안성시	금광면	6113	4565	2182	2152	105	5	45	1	0	1	6	10	1	5	4513	52	1548
413804	경기도	안성시	서운면	3190	2446	1018	1300	55	3	27	0	0	0	3	6	0	1	2413	33	744
413805	경기도	안성시	미양면	5152	3617	1675	1765	80	5	34	2	1	1	9	5	1	2	3580	37	1535
413806	경기도	안성시	대덕면	12480	8365	4231	3721	208	5	94	2	0	1	5	17	1	2	8287	78	4115
413807	경기도	안성시	양성면	4619	3370	1317	1903	68	2	30	1	0	0	6	3	1	0	3331	39	1249
413808	경기도	안성시	원곡면	5253	3623	1610	1846	77	2	44	0	0	2	1	5	1	4	3592	31	1630
413809	경기도	안성시	일죽면	6198	4491	1693	2592	82	4	49	0	0	0	4	1	4	1	4430	61	1707
413810	경기도	안성시	죽산면	6012	4313	1757	2354	63	9	62	1	2	2	2	2	3	2	4259	54	1699
413811	경기도	안성시	삼죽면	3093	2260	889	1257	52	2	22	0	2	2	1	5	0	1	2233	27	833
413812	경기도	안성시	고삼면	2276	1889	830	981	31	3	12	0	1	0	2	4	0	1	1865	24	387
413813	경기도	안성시	안성1동	10856	8007	3510	4099	214	10	72	2	1	3	6	7	1	4	7929	78	2849
413814	경기도	안성시	안성2동	19449	13590	6915	5983	374	9	148	1	3	1	4	11	1	8	13458	132	5859
413815	경기도	안성시	안성3동	16689	11774	5685	5450	383	7	102	4	1	1	5	18	3	5	11664	110	4915
413901	경기도	김포시	통진읍	23083	15514	7375	7419	303	9	231	5	3	2	10	18	5	7	15387	127	7569
413902	경기도	김포시	고촌읍	34177	27375	13117	13258	650	6	134	2	6	7	22	14	3	5	27224	151	6802
413903	경기도	김포시	양촌읍	22685	15739	7978	7131	303	4	172	3	3	9	10	13	9	6	15641	98	6946
413904	경기도	김포시	대곶면	8575	5996	2370	3418	95	3	51	0	0	1	5	8	2	2	5955	41	2579
413905	경기도	김포시	월곶면	5246	3833	1507	2120	65	6	57	2	1	4	3	8	2	2	3777	56	1413
413906	경기도	김포시	하성면	7481	5501	2270	3022	89	1	63	0	0	2	3	1	2	1	5454	47	1980
413909	경기도	김포시	사우동	21770	16920	8714	7526	419	8	99	3	0	1	12	16	4	2	16804	116	4850
413910	경기도	김포시	풍무동	43898	33644	17135	15282	728	12	191	7	3	16	27	24	4	7	33436	208	10254
413911	경기도	김포시	장기동	30548	23650	12698	10079	560	15	133	6	2	4	9	12	7	4	23529	121	6898
413912	경기도	김포시	구래동	32995	23774	13124	9663	572	13	188	3	1	4	16	16	4	8	23612	162	9221
413913	경기도	김포시	운양동	33180	25409	13146	11338	613	3	119	2	1	3	18	14	4	6	25267	142	7771
413914	경기도	김포시	김포본동	43172	32903	16033	15493	824	12	210	7	1	9	25	17	10	5	32646	257	10269
413915	경기도	김포시	장기본동	26727	20378	10441	9211	448	8	109	2	1	3	14	13	6	2	20258	120	6349
413916	경기도	김포시	마산동	25514	19237	10726	7734	465	5	128	4	2	2	10	11	8	4	19099	138	6277
414001	경기도	광주시	오포읍	77415	52918	28362	22718	933	17	414	7	5	18	32	64	6	16	52592	326	24497
414002	경기도	광주시	초월읍	34754	24654	12964	10805	486	4	177	4	2	5	19	28	6	6	24506	148	10100
414003	경기도	광주시	곤지암읍	19181	13632	6587	6515	239	14	140	4	1	2	7	15	5	9	13538	94	5549
414004	경기도	광주시	도척면	7792	5576	2596	2789	96	3	50	3	0	1	2	5	3	1	5549	27	2216
414005	경기도	광주시	퇴촌면	12485	8993	4261	4463	121	3	65	1	2	4	4	8	1	2	8935	58	3492
414006	경기도	광주시	남종면	1407	1152	406	704	16	2	10	0	0	0	3	0	1	1	1143	9	255
414007	경기도	광주시	남한산성면	2273	1818	748	1019	27	0	10	0	0	0	2	3	0	0	1809	9	455
414008	경기도	광주시	경안동	24713	18368	9310	8289	385	10	167	5	3	6	15	26	8	5	18229	139	6345
414009	경기도	광주시	송정동	17039	12272	6228	5550	260	4	112	3	1	1	9	3	5	9	12185	87	4767
414011	경기도	광주시	쌍령동	14153	10783	6094	4295	246	3	61	2	0	2	7	12	3	2	10727	56	3370
414012	경기도	광주시	탄벌동	29520	20758	11453	8588	367	6	153	6	3	3	18	25	8	12	20642	116	8762
414013	경기도	광주시	광남1동	24297	16960	9317	7063	283	5	133	3	4	4	13	22	1	0	16848	112	7337
414014	경기도	광주시	광남2동	23599	18761	10761	7403	371	8	92	1	6	5	2	20	2	3	18674	87	4838
414101	경기도	포천시	소흘읍	35560	24879	12819	11058	507	4	251	2	6	6	23	32	2	8	24718	161	10681
414102	경기도	포천시	군내면	6523	4612	1959	2437	89	3	57	2	3	3	5	8	5	2	4573	39	1911
414103	경기도	포천시	내촌면	3982	2863	1162	1571	36	2	43	0	0	1	3	2	2	1	2823	40	1119
414104	경기도	포천시	가산면	6772	4851	2096	2581	74	3	36	1	1	3	6	7	7	4	4819	32	1921
414105	경기도	포천시	신북면	9630	6454	2779	3410	113	4	69	2	0	0	8	13	5	2	6405	49	3176
414106	경기도	포천시	창수면	1914	1495	562	874	21	1	18	0	1	0	3	3	0	1	1484	11	419
414107	경기도	포천시	영중면	4221	3115	1330	1656	38	2	36	1	0	0	7	5	4	3	3082	33	1106
414108	경기도	포천시	일동면	7999	5705	2328	3140	108	0	54	2	0	1	9	3	2	5	5652	53	2294
414109	경기도	포천시	이동면	4838	3500	1391	1958	64	2	36	0	0	0	7	3	1	2	3464	36	1338
414110	경기도	포천시	영북면	6666	4670	1871	2554	100	5	71	3	0	1	6	4	3	6	4624	46	1996
414111	경기도	포천시	관인면	2348	1755	695	998	27	0	17	0	0	0	1	4	0	1	1743	12	593
414112	경기도	포천시	화현면	2216	1625	591	946	36	0	20	1	0	1	8	2	1	1	1607	18	591
414113	경기도	포천시	포천동	16343	11862	5700	5619	261	10	122	3	0	1	11	27	4	3	11761	101	4481
414114	경기도	포천시	선단동	12450	8262	4170	3705	186	8	83	1	3	2	5	11	2	4	8180	82	4188
414201	경기도	연천군	연천읍	6046	4507	1884	2387	84	4	56	3	0	2	5	15	3	4	4447	60	1539
414202	경기도	연천군	전곡읍	14595	10415	4539	5362	229	5	148	1	0	4	9	13	10	5	10325	90	4180
414203	경기도	연천군	군남면	2457	1816	717	1013	41	1	21	1	0	1	3	4	1	1	1804	12	641
414204	경기도	연천군	청산면	3357	2508	914	1432	40	3	34	1	1	1	42	5	2	6	2481	27	849
414205	경기도	연천군	백학면	2154	1638	631	927	36	1	27	0	1	0	0	1	2	1	1627	11	516
414206	경기도	연천군	미산면	1333	1001	376	585	15	0	11	0	0	0	2	1	0	2	992	9	332
414207	경기도	연천군	왕징면	937	761	286	448	12	0	8	0	1	0	0	1	1	1	758	3	176
414208	경기도	연천군	신서면	2353	1867	776	994	26	1	31	1	0	4	1	3	2	4	1843	24	486
414209	경기도	연천군	중면	190	156	67	80	4	0	3	0	0	0	0	0	0	0	154	2	34
414210	경기도	연천군	장남면	641	530	193	310	15	0	6	0	0	0	0	0	0	0	524	6	111
414301	경기도	양평군	양평읍	22411	16105	6692	8744	382	7	143	3	2	2	13	9	7	5	16009	96	6306
414302	경기도	양평군	강상면	8590	6801	3008	3559	144	2	45	2	2	2	8	2	3	1	6778	23	1789
414303	경기도	양평군	강하면	3872	2990	1081	1822	41	1	20	0	0	1	5	2	2	0	2975	15	882
414304	경기도	양평군	양서면	10366	7692	3260	4126	165	5	43	0	1	5	12	7	0	6	7630	62	2674
414305	경기도	양평군	옥천면	7243	5748	2471	3055	115	1	60	1	0	3	2	4	1	2	5715	33	1495
414306	경기도	양평군	서종면	6953	5286	2179	2932	90	0	26	4	0	1	9	3	3	2	5249	37	1667
414307	경기도	양평군	단월면	3311	2550	974	1484	35	3	19	0	1	2	1	0	0	4	2523	27	761
414308	경기도	양평군	청운면	3184	2371	843	1432	40	1	13	2	1	3	4	4	3	2	2348	23	813
414309	경기도	양평군	양동면	3752	2831	978	1744	47	4	20	1	1	1	2	5	2	4	2809	22	921
414310	경기도	양평군	지평면	5853	4466	1773	2541	64	1	32	3	1	1	7	2	4	4	4433	33	1387
414311	경기도	양평군	용문면	13726	10210	4246	5559	183	8	93	4	2	1	5	9	3	8	10121	89	3516
414312	경기도	양평군	개군면	4358	3408	1344	1939	68	0	21	0	0	0	7	1	2	2	3384	24	950
414401	경기도	가평군	가평읍	15629	11538	4706	6389	255	2	75	2	1	3	5	7	7	6	11458	80	4091
414402	경기도	가평군	설악면	7473	5558	1933	3429	92	1	38	1	1	1	9	3	2	5	5515	43	1915
414403	경기도	가평군	청평면	11292	8330	3269	4731	165	5	76	1	0	2	12	5	3	4	8273	57	2962
414404	경기도	가평군	상면	4593	3426	1249	2010	70	4	37	1	0	2	2	2	2	4	3383	43	1167
414406	경기도	가평군	북면	3086	2343	819	1433	37	1	25	0	0	0	4	5	1	2	2327	16	743
414407	경기도	가평군	조종면	7288	5176	2045	2769	119	10	77	10	3	7	6	7	10	3	5066	110	2112
414537	경기도	부천시	심곡동	53909	36781	19823	15241	884	26	347	10	9	14	29	38	8	14	36443	338	17128
414538	경기도	부천시	부천동	74822	55352	30924	21978	1386	46	434	18	3	12	33	63	9	24	54930	422	19470
414539	경기도	부천시	중동	33254	25113	12549	11513	626	19	152	5	4	5	23	18	5	10	24929	184	8141
414540	경기도	부천시	신중동	102278	78631	39756	35771	1928	48	390	14	14	17	37	55	17	21	78068	563	23647
414541	경기도	부천시	상동	65597	52781	27545	23141	1413	18	215	12	4	13	26	19	5	13	52424	357	12816
414542	경기도	부천시	대산동	65980	48304	25192	20968	1244	25	337	18	4	12	34	39	8	13	47894	410	17676
414543	경기도	부천시	소사본동	44275	32882	17035	14489	766	23	221	5	7	6	37	30	8	14	32641	241	11393
414544	경기도	부천시	범안동	70059	53963	29679	22048	1386	30	317	10	3	12	27	49	14	16	53591	372	16096
414545	경기도	부천시	성곡동	67534	48086	27158	18895	1057	38	419	11	5	9	25	47	13	30	47707	379	19448
414546	경기도	부천시	오정동	67068	47076	26030	18924	1125	32	399	8	8	12	38	56	14	29	46675	401	19992
420101	강원도	춘천시	신북읍	7611	5948	2465	3182	148	4	70	3	0	1	2	12	5	3	5895	53	1663
420102	강원도	춘천시	동면	12948	9575	4406	4705	262	5	109	3	0	2	6	12	2	2	9514	61	3373
420103	강원도	춘천시	동산면	1369	1035	363	633	13	0	10	1	0	1	1	0	2	0	1024	11	334
420104	강원도	춘천시	신동면	3617	3081	1338	1607	82	2	19	2	0	0	2	3	0	1	3056	25	536
420105	강원도	춘천시	동내면	14557	11205	5203	5458	317	13	106	5	1	0	3	15	0	7	11128	77	3352
420106	강원도	춘천시	남면	902	692	225	445	12	0	4	2	0	0	0	1	0	0	689	3	210
420107	강원도	춘천시	남산면	3107	2379	868	1424	37	0	29	0	0	0	2	2	1	0	2363	16	728
420108	강원도	춘천시	서면	3335	2486	894	1486	60	1	20	1	1	0	0	3	3	1	2470	16	849
420109	강원도	춘천시	사북면	1994	1480	527	871	38	2	16	0	2	0	2	7	2	1	1468	12	514
420110	강원도	춘천시	북산면	756	591	173	394	11	0	4	0	1	0	0	0	1	2	586	5	165
420111	강원도	춘천시	소양동	7687	5988	2762	2973	148	7	45	4	0	0	2	5	5	1	5952	36	1699
420112	강원도	춘천시	교동	3612	2784	1150	1475	74	2	38	1	0	1	0	4	1	1	2747	37	828
420113	강원도	춘천시	조운동	3274	2540	1095	1306	79	1	20	0	2	1	5	0	2	2	2513	27	734
420114	강원도	춘천시	약사명동	3908	3218	1434	1639	94	1	21	4	0	0	0	2	0	2	3197	21	690
420115	강원도	춘천시	근화동	6462	4573	2070	2284	120	2	47	5	0	1	5	2	0	2	4538	35	1889
420116	강원도	춘천시	후평1동	10453	7491	3049	4054	202	9	86	0	2	1	5	7	4	2	7421	70	2962
420117	강원도	춘천시	후평2동	11336	8370	3721	4241	254	8	69	6	1	0	5	3	2	2	8312	58	2966
420118	강원도	춘천시	후평3동	16559	12121	5328	6214	336	9	105	4	0	5	10	11	4	6	12032	89	4438
420119	강원도	춘천시	효자1동	4338	3504	1470	1862	108	3	34	1	0	0	2	3	2	1	3486	18	834
420120	강원도	춘천시	효자2동	9650	6563	2624	3548	180	4	85	3	0	3	7	14	5	2	6475	88	3087
420121	강원도	춘천시	효자3동	4075	2987	1163	1617	108	2	29	2	0	1	1	8	1	3	2935	52	1088
420122	강원도	춘천시	석사동	25642	19046	8636	9466	597	6	155	6	7	0	10	17	2	5	18907	139	6596
420123	강원도	춘천시	퇴계동	33765	25316	11555	12571	742	9	199	9	2	1	14	24	4	7	25137	179	8449
420124	강원도	춘천시	강남동	17690	13666	5990	7086	381	5	88	3	4	2	2	10	2	1	13574	92	4024
420125	강원도	춘천시	신사우동	18091	13650	6112	6891	385	11	124	6	2	2	9	15	3	2	13562	88	4441
420201	강원도	원주시	문막읍	14893	10394	4807	5061	253	6	139	6	1	1	13	5	9	5	10306	88	4499
420202	강원도	원주시	소초면	6818	4889	1691	2944	111	4	57	2	2	1	26	5	3	4	4850	39	1929
420203	강원도	원주시	호저면	3446	2606	932	1540	51	2	35	0	3	0	3	3	4	2	2575	31	840
420204	강원도	원주시	지정면	18683	13552	6827	6057	371	6	156	3	3	5	7	9	1	5	13450	102	5131
420205	강원도	원주시	부론면	1917	1484	421	1011	29	0	9	0	0	0	2	0	0	1	1473	11	433
420206	강원도	원주시	귀래면	2077	1623	546	996	44	2	16	0	0	0	1	1	2	2	1610	13	454
420207	강원도	원주시	흥업면	8581	6604	2928	3349	156	4	74	1	0	4	6	7	2	3	6534	70	1977
420208	강원도	원주시	판부면	6209	4601	2114	2269	106	1	57	3	3	1	2	4	0	3	4563	38	1608
420209	강원도	원주시	신림면	3374	2664	968	1590	41	0	44	1	0	0	0	6	2	2	2654	10	710
420210	강원도	원주시	중앙동	3722	2935	1117	1702	55	2	25	2	1	1	4	4	1	3	2917	18	787
420211	강원도	원주시	원인동	3721	2565	1025	1403	60	3	36	0	0	0	3	6	3	1	2540	25	1156
420212	강원도	원주시	개운동	10724	7880	3229	4303	171	6	75	1	2	4	11	12	3	1	7818	62	2844
420213	강원도	원주시	명륜1동	9105	7283	3145	3763	219	5	65	6	1	0	7	10	4	3	7228	55	1822
420214	강원도	원주시	명륜2동	13430	9935	4355	5082	234	8	121	2	2	5	11	15	4	3	9842	93	3495
420215	강원도	원주시	단구동	33408	23382	10838	11353	643	19	277	2	4	4	14	31	4	12	23201	181	10026
420216	강원도	원주시	일산동	7551	5473	2179	2982	145	3	67	0	0	2	12	4	3	3	5400	73	2078
420217	강원도	원주시	학성동	5238	4005	1603	2205	100	3	44	2	0	0	1	8	4	5	3975	30	1233
420218	강원도	원주시	단계동	22823	16553	7025	8678	468	8	180	3	3	3	13	22	2	3	16408	145	6270
420219	강원도	원주시	우산동	10943	7874	3206	4280	188	5	104	3	2	2	6	13	3	1	7813	61	3069
420220	강원도	원주시	태장1동	8766	6368	2899	3145	149	2	92	2	1	4	7	13	5	3	6322	46	2398
420221	강원도	원주시	태장2동	19299	13407	5851	6787	379	9	208	4	2	4	12	17	9	10	13292	115	5892
420222	강원도	원주시	봉산동	6621	4893	1884	2764	108	10	53	1	0	1	14	9	1	1	4846	47	1728
420223	강원도	원주시	행구동	6986	5584	2526	2817	147	4	46	0	0	4	7	4	0	1	5556	28	1402
420224	강원도	원주시	무실동	25003	17963	8528	8573	517	8	145	1	2	4	13	15	5	8	17819	144	7040
420225	강원도	원주시	반곡관설동	28184	20645	10333	9203	705	5	186	6	2	5	21	20	4	3	20493	152	7539
420301	강원도	강릉시	주문진읍	14258	9921	3287	6248	163	7	86	0	1	4	13	6	2	6	9823	98	4337
420302	강원도	강릉시	성산면	3264	2601	895	1604	51	2	19	1	0	0	2	3	2	1	2580	21	663
420303	강원도	강릉시	왕산면	1298	1044	280	713	25	0	8	2	0	0	1	1	0	2	1032	12	254
420304	강원도	강릉시	구정면	4019	3166	1135	1916	66	1	25	2	0	2	2	3	1	2	3155	11	853
420305	강원도	강릉시	강동면	4036	3116	930	2052	50	1	28	2	2	0	2	6	2	1	3076	40	920
420306	강원도	강릉시	옥계면	3114	2401	680	1607	44	0	32	0	1	0	3	3	2	1	2373	28	713
420307	강원도	강릉시	사천면	4467	3568	1296	2069	86	3	39	4	1	3	6	8	3	4	3522	46	899
420308	강원도	강릉시	연곡면	5823	4483	1667	2616	88	4	60	2	1	1	4	6	1	4	4454	29	1340
420309	강원도	강릉시	홍제동	11226	8402	3353	4674	215	3	79	2	0	0	6	14	1	1	8348	54	2824
420310	강원도	강릉시	중앙동	5276	4114	1353	2599	80	1	42	1	2	4	3	4	0	2	4091	23	1162
420311	강원도	강릉시	옥천동	3893	3022	991	1911	53	1	42	0	1	0	3	3	1	1	3007	15	871
420312	강원도	강릉시	교1동	20176	15263	6370	8193	395	4	146	2	2	2	7	13	7	6	15147	116	4913
420313	강원도	강릉시	교2동	7145	5439	2051	3158	130	3	47	1	2	3	4	7	1	3	5410	29	1706
420314	강원도	강릉시	포남1동	8759	6444	2150	4008	133	3	68	0	1	1	12	8	6	2	6392	52	2315
420315	강원도	강릉시	포남2동	10859	8024	2903	4715	192	7	100	1	2	10	4	9	3	3	7949	75	2835
420316	강원도	강릉시	초당동	4150	3291	1393	1739	92	1	35	1	1	0	2	5	1	1	3271	20	859
420317	강원도	강릉시	송정동	7736	5996	2452	3271	150	0	57	0	2	0	6	3	2	0	5943	53	1740
420318	강원도	강릉시	내곡동	12218	9024	3803	4759	251	3	102	2	2	1	5	13	2	4	8947	77	3194
420319	강원도	강릉시	강남동	14575	10635	3798	6322	245	11	122	4	1	2	12	13	9	5	10544	91	3940
420320	강원도	강릉시	성덕동	20716	15041	6467	7779	438	8	164	6	5	2	15	14	6	10	14914	127	5675
420321	강원도	강릉시	경포동	6931	5039	2004	2786	149	1	39	1	0	0	4	11	0	2	4997	42	1892
420401	강원도	동해시	천곡동	22099	15891	6393	8832	390	5	146	3	1	2	15	12	1	5	15805	86	6208
420402	강원도	동해시	송정동	3486	2587	893	1557	60	1	35	1	1	0	5	4	3	0	2560	27	899
420403	강원도	동해시	북삼동	15133	11010	4890	5597	272	3	146	0	1	6	6	12	4	2	10939	71	4123
420404	강원도	동해시	부곡동	4800	3563	1378	2026	67	0	55	1	0	0	7	6	0	0	3540	23	1237
420405	강원도	동해시	동호동	4132	3000	1072	1805	59	2	30	0	2	0	0	2	3	1	2976	24	1132
420406	강원도	동해시	발한동	3259	2318	714	1516	37	1	31	1	0	0	3	2	1	0	2306	12	941
420407	강원도	동해시	묵호동	2628	1786	611	1111	20	0	23	1	0	1	2	0	0	1	1770	16	842
420408	강원도	동해시	북평동	9664	7033	2896	3785	193	6	86	3	0	0	6	4	2	3	6984	49	2631
420409	강원도	동해시	망상동	2926	2043	678	1276	27	0	27	0	0	0	8	2	3	0	2021	22	883
420410	강원도	동해시	삼화동	2612	1955	639	1220	40	1	23	1	0	0	1	5	4	2	1936	19	657
420501	강원도	삼척시	도계읍	7742	5698	1774	3645	101	4	60	3	2	3	8	11	7	4	5622	76	2044
420502	강원도	삼척시	원덕읍	4296	3305	1088	2076	51	5	29	2	1	1	6	7	7	1	3274	31	991
420503	강원도	삼척시	근덕면	4481	3422	1065	2221	55	1	24	3	0	4	2	4	9	3	3391	31	1059
420504	강원도	삼척시	하장면	1039	784	257	490	7	0	16	0	0	1	2	1	1	3	778	6	255
420505	강원도	삼척시	노곡면	606	490	148	322	9	0	5	0	0	0	1	0	1	0	486	4	116
420506	강원도	삼척시	미로면	1620	1260	388	820	22	0	12	0	0	2	0	2	3	3	1252	8	360
420507	강원도	삼척시	가곡면	595	493	166	288	13	0	10	0	0	0	1	2	2	2	484	9	102
420508	강원도	삼척시	신기면	606	475	166	276	6	1	6	0	2	0	0	3	4	2	466	9	131
420509	강원도	삼척시	남양동	6421	4879	1601	3086	79	2	52	3	0	5	3	4	2	1	4838	41	1542
420510	강원도	삼척시	성내동	7546	6064	2434	3370	133	6	53	4	1	3	2	5	7	4	6022	42	1482
420511	강원도	삼척시	교동	10809	8237	3704	4158	212	1	82	4	1	1	1	7	3	6	8180	57	2572
420512	강원도	삼척시	정라동	5638	3756	1391	2195	81	1	28	5	1	1	2	4	1	1	3711	45	1882
420601	강원도	태백시	황지동	5699	4482	1848	2463	76	0	48	3	0	1	1	7	2	0	4449	33	1217
420602	강원도	태백시	황연동	4051	3079	1111	1861	47	0	29	1	0	0	3	5	1	2	3060	19	972
420603	강원도	태백시	삼수동	4375	3002	1165	1736	44	1	25	0	0	1	5	4	3	4	2988	14	1373
420604	강원도	태백시	상장동	8456	5937	2681	3021	140	3	54	0	0	1	0	2	1	4	5907	30	2519
420605	강원도	태백시	문곡소도동	3062	2249	876	1283	36	2	19	0	1	0	4	2	2	1	2226	23	813
420606	강원도	태백시	장성동	3130	2455	962	1426	29	1	23	0	0	0	1	0	2	1	2445	10	675
420607	강원도	태백시	구문소동	2141	1652	527	1039	36	2	22	2	0	2	2	0	4	5	1641	11	489
420608	강원도	태백시	철암동	1852	1423	423	943	24	0	17	1	0	0	2	0	1	0	1411	12	429
420701	강원도	정선군	정선읍	8127	6139	2714	3135	140	3	73	0	0	2	5	6	6	5	6089	50	1988
420702	강원도	정선군	고한읍	3598	2565	1115	1343	55	0	23	0	0	1	3	4	1	1	2546	19	1033
420703	강원도	정선군	사북읍	3885	2806	1131	1562	43	0	37	0	0	1	4	3	3	1	2785	21	1079
420704	강원도	정선군	신동읍	2827	2184	873	1194	43	2	36	1	0	0	1	3	3	3	2159	25	643
420705	강원도	정선군	화암면	1323	993	371	576	19	0	15	0	0	0	0	3	1	2	987	6	330
420706	강원도	정선군	남면	2563	1897	750	1085	27	0	19	0	0	0	2	2	2	0	1887	10	666
420707	강원도	정선군	여량면	1713	1356	419	867	17	0	20	1	0	0	0	7	3	2	1336	20	357
420708	강원도	정선군	북평면	2085	1605	609	931	29	1	16	1	0	0	3	1	1	1	1593	12	480
420709	강원도	정선군	임계면	2943	2346	810	1453	34	0	11	0	0	1	1	5	7	2	2324	22	597
420801	강원도	속초시	영랑동	4655	3594	1458	2016	72	0	20	1	1	1	0	7	1	1	3578	16	1061
420802	강원도	속초시	동명동	2791	2016	745	1193	40	0	28	1	0	0	1	1	0	0	2009	7	775
420803	강원도	속초시	금호동	5156	3702	1319	2250	64	0	40	1	0	1	3	1	0	0	3679	23	1454
420804	강원도	속초시	교동	8083	5695	2200	3222	131	4	82	1	0	1	3	5	4	2	5655	40	2388
420805	강원도	속초시	노학동	16808	11764	4888	6343	289	1	137	3	1	3	8	6	2	3	11684	80	5044
420806	강원도	속초시	조양동	20580	14130	6343	7162	310	4	161	6	3	5	5	8	2	3	14012	118	6450
420807	강원도	속초시	청호동	4445	3285	1299	1807	89	4	41	1	0	0	1	5	5	1	3253	32	1160
420808	강원도	속초시	대포동	2810	2170	722	1356	41	0	23	0	0	0	0	1	1	2	2146	24	640
420901	강원도	고성군	간성읍	5486	4177	1728	2215	122	3	52	1	1	2	0	3	4	4	4135	42	1309
420902	강원도	고성군	거진읍	5093	3748	1339	2254	60	2	36	1	0	0	1	7	3	7	3710	38	1345
420903	강원도	고성군	현내면	1984	1567	530	965	32	0	13	1	0	0	0	2	2	4	1549	18	417
420904	강원도	고성군	죽왕면	2910	2238	772	1380	37	0	19	1	0	0	0	2	4	2	2217	21	672
420905	강원도	고성군	토성면	6520	4849	1889	2747	112	1	53	1	1	1	7	2	4	0	4818	31	1671
421001	강원도	양양군	양양읍	10123	7563	2925	4332	168	2	76	0	4	1	5	4	4	2	7523	40	2560
421002	강원도	양양군	서면	2394	1841	595	1146	45	0	21	0	1	0	0	2	5	0	1815	26	553
421003	강원도	양양군	손양면	2002	1558	578	916	31	0	21	0	0	0	0	1	1	0	1548	10	444
421004	강원도	양양군	현북면	2117	1643	602	974	26	0	25	0	1	0	1	1	3	0	1633	10	474
421005	강원도	양양군	현남면	2410	1802	524	1197	41	1	16	0	1	0	1	0	1	3	1785	17	608
421006	강원도	양양군	강현면	3713	2831	1056	1651	52	0	38	2	0	1	4	1	0	1	2806	25	882
421101	강원도	인제군	인제읍	8138	6149	2776	3056	141	6	83	0	0	3	5	12	2	3	6087	62	1989
421102	강원도	인제군	남면	2911	2118	823	1172	51	1	33	0	0	0	4	2	1	4	2091	27	793
421103	강원도	인제군	북면	6393	4825	1979	2598	98	4	74	0	1	2	2	9	3	6	4776	49	1568
421104	강원도	인제군	기린면	3901	3091	1123	1741	78	5	51	3	2	2	1	5	5	5	3021	70	810
421105	강원도	인제군	서화면	2018	1552	572	856	41	4	34	1	1	1	1	4	1	1	1517	35	466
421106	강원도	인제군	상남면	1639	1226	455	699	20	0	26	0	0	0	1	1	0	1	1203	23	413
421201	강원도	홍천군	홍천읍	26190	18848	7963	9924	476	11	232	2	7	8	13	31	7	10	18684	164	7342
421202	강원도	홍천군	화촌면	3817	2901	1100	1650	46	3	52	0	0	2	1	12	0	3	2869	32	916
421203	강원도	홍천군	두촌면	2043	1562	521	981	26	0	9	3	0	0	0	0	5	2	1547	15	481
421204	강원도	홍천군	내촌면	1980	1543	507	966	36	1	12	1	0	2	1	0	0	3	1529	14	437
421205	강원도	홍천군	서석면	3159	2430	907	1403	51	4	36	0	1	1	0	4	3	0	2410	20	729
421207	강원도	홍천군	남면	5073	3760	1376	2149	81	5	74	2	1	1	3	27	3	1	3723	37	1313
421208	강원도	홍천군	서면	3027	2236	751	1400	41	2	17	1	0	0	1	5	1	1	2220	16	791
421209	강원도	홍천군	북방면	3628	2837	1032	1667	56	3	33	2	0	1	4	5	3	3	2809	28	791
421210	강원도	홍천군	내면	2452	1917	707	1121	26	1	24	3	0	2	4	5	1	3	1897	20	535
421211	강원도	홍천군	영귀미면	3612	2838	1074	1568	69	3	29	0	1	1	1	44	7	4	2801	37	774
421301	강원도	횡성군	횡성읍	16350	12076	4972	6496	295	7	147	4	1	1	8	12	4	7	11954	122	4274
421302	강원도	횡성군	우천면	3798	2902	1036	1715	46	1	64	1	0	2	5	5	2	2	2879	23	896
421303	강원도	횡성군	안흥면	2390	1893	695	1133	26	0	18	0	0	0	1	5	2	1	1881	12	497
421304	강원도	횡성군	둔내면	4844	3701	1385	2147	66	1	61	1	0	1	8	1	4	1	3676	25	1143
421305	강원도	횡성군	갑천면	2029	1563	520	976	33	2	9	2	0	2	1	1	3	2	1551	12	466
421306	강원도	횡성군	청일면	1949	1479	486	928	27	0	13	0	0	0	0	6	2	2	1464	15	470
421307	강원도	횡성군	공근면	2992	2354	815	1433	33	5	36	1	1	1	1	3	3	3	2335	19	638
421308	강원도	횡성군	서원면	1751	1390	492	841	27	1	9	1	1	0	1	2	2	0	1377	13	361
421309	강원도	횡성군	강림면	1410	1133	424	678	16	1	5	0	0	0	1	1	0	0	1126	7	277
421401	강원도	영월군	영월읍	16136	11903	5192	6204	243	3	123	5	0	5	12	16	8	3	11814	89	4233
421402	강원도	영월군	상동읍	876	680	267	378	17	0	4	0	0	1	0	3	2	0	672	8	196
421404	강원도	영월군	김삿갓면	1426	1129	402	679	19	0	14	2	0	1	1	2	1	2	1123	6	297
421405	강원도	영월군	북면	1730	1313	461	778	27	2	22	1	0	1	4	3	1	0	1300	13	417
421406	강원도	영월군	남면	2204	1795	657	1049	31	2	21	1	0	2	3	4	3	4	1777	18	409
421407	강원도	영월군	한반도면	2261	1765	612	1069	32	0	20	1	0	1	4	1	1	3	1744	21	496
421408	강원도	영월군	주천면	3211	2499	864	1545	43	2	17	0	1	1	3	3	2	1	2482	17	712
421410	강원도	영월군	무릉도원면	1490	1185	361	771	19	0	17	3	1	0	2	1	2	0	1177	8	305
421411	강원도	영월군	산솔면	1237	958	300	605	23	0	13	1	0	1	4	2	2	1	952	6	279
421501	강원도	평창군	평창읍	6820	5336	2127	2966	110	3	64	1	0	2	7	7	5	5	5297	39	1484
421502	강원도	평창군	미탄면	1409	1141	425	679	12	2	9	0	0	0	0	1	2	2	1132	9	268
421503	강원도	평창군	방림면	2064	1597	635	883	30	4	16	1	3	0	12	2	3	2	1591	6	467
421504	강원도	평창군	대화면	4196	3149	1297	1710	58	1	42	1	2	0	3	2	5	3	3124	25	1047
421505	강원도	평창군	봉평면	4482	3396	1285	1966	67	1	53	0	1	0	1	1	2	1	3378	18	1086
421506	강원도	평창군	용평면	2474	1950	743	1148	23	0	13	0	0	0	0	2	2	2	1933	17	524
421507	강원도	평창군	진부면	7101	5337	2088	2993	122	2	68	0	1	2	5	10	2	2	5295	42	1764
421508	강원도	평창군	대관령면	4639	3352	1216	1974	70	1	50	0	1	1	4	4	4	3	3328	24	1287
421601	강원도	화천군	화천읍	6258	4710	1924	2506	132	2	68	3	1	1	7	6	0	7	4657	53	1548
421602	강원도	화천군	간동면	2138	1639	621	942	25	2	20	0	0	0	4	6	4	3	1627	12	499
421603	강원도	화천군	하남면	2423	1928	749	1081	43	1	28	0	0	1	2	2	3	0	1910	18	495
421604	강원도	화천군	상서면	3066	2246	802	1271	65	2	54	0	1	1	1	6	0	1	2204	42	820
421605	강원도	화천군	사내면	4658	3451	1316	1911	107	2	64	2	1	0	3	5	0	3	3414	37	1207
421701	강원도	양구군	양구읍	9998	7532	3026	4020	222	8	127	3	5	1	7	15	6	9	7449	83	2466
421703	강원도	양구군	동면	1699	1313	477	758	29	1	20	0	0	0	1	2	1	4	1293	20	386
421704	강원도	양구군	방산면	1061	830	328	459	17	0	17	0	0	0	0	0	2	1	824	6	231
421705	강원도	양구군	해안면	1033	797	332	415	21	0	16	0	0	1	1	1	3	1	791	6	236
421706	강원도	양구군	국토정중앙면	2740	2047	667	1267	45	2	36	1	2	0	3	0	4	2	2029	18	693
421801	강원도	철원군	철원읍	4251	3174	1353	1665	78	0	31	1	0	0	4	2	2	4	3140	34	1077
421802	강원도	철원군	김화읍	2545	1892	729	1066	42	1	29	0	0	0	1	3	1	1	1873	19	653
421803	강원도	철원군	갈말읍	9362	6811	2617	3860	181	3	64	0	2	0	5	5	5	7	6749	62	2551
421804	강원도	철원군	동송읍	11228	7932	3111	4429	190	4	97	0	1	4	3	8	2	3	7852	80	3296
421805	강원도	철원군	서면	4541	3305	1298	1823	76	3	58	2	2	0	1	1	2	0	3266	39	1236
421806	강원도	철원군	근남면	1728	1284	463	743	32	1	21	0	0	1	0	0	0	0	1261	23	444
421807	강원도	철원군	근북면	127	108	45	56	2	0	1	0	0	0	0	2	0	0	106	2	19
430101	충청북도	청주시상당구	중앙동	5491	3903	1507	2189	124	3	39	0	0	1	1	1	0	2	3867	36	1588
430102	충청북도	청주시상당구	성안동	6620	4893	1907	2722	135	2	54	5	3	1	7	3	0	4	4843	50	1727
430103	충청북도	청주시상당구	탑·대성동	6291	4266	1559	2473	120	3	49	2	2	2	4	3	1	1	4219	47	2025
430104	충청북도	청주시상당구	용담·명암·산성동	10190	7907	3960	3590	208	5	60	4	1	1	4	6	0	2	7841	66	2283
430105	충청북도	청주시상당구	금천동	24502	18081	8386	8786	505	6	187	8	1	6	11	14	2	9	17921	160	6421
430106	충청북도	청주시상당구	영운동	9111	6425	2684	3388	181	5	78	2	1	1	6	4	4	3	6357	68	2686
430107	충청북도	청주시상당구	용암제1동	38453	26945	13117	12404	802	25	272	7	5	11	21	19	3	5	26691	254	11508
430108	충청북도	청주시상당구	용암제2동	28235	20620	10176	9307	695	3	197	11	1	4	4	22	7	15	20442	178	7615
430109	충청북도	청주시상당구	낭성면	2079	1635	553	996	33	5	13	1	0	2	2	1	2	1	1609	26	444
430110	충청북도	청주시상당구	미원면	4198	3108	1069	1867	56	3	29	3	0	1	3	12	7	7	3057	51	1090
430111	충청북도	청주시상당구	가덕면	3437	2583	941	1494	45	1	31	2	1	0	3	3	3	6	2530	53	854
430112	충청북도	청주시상당구	남일면	6188	4691	1941	2501	122	4	50	5	2	1	5	4	1	3	4639	52	1497
430113	충청북도	청주시상당구	문의면	3400	2572	925	1497	57	4	30	2	0	0	7	3	5	2	2532	40	828
430201	충청북도	청주시흥덕구	오송읍	17082	12577	6375	5494	383	5	134	1	1	4	12	14	1	2	12426	151	4505
430202	충청북도	청주시흥덕구	강내면	9007	6837	3192	3331	181	4	55	0	2	0	7	5	2	3	6782	55	2170
430203	충청북도	청주시흥덕구	옥산면	13794	9987	4849	4612	283	5	118	4	5	4	3	8	4	5	9900	87	3807
430204	충청북도	청주시흥덕구	운천·신봉동	13289	9220	4076	4687	244	8	87	4	0	0	4	12	0	2	9124	96	4069
430205	충청북도	청주시흥덕구	복대제1동	36581	26135	12557	12271	755	11	234	4	3	3	7	21	8	10	25884	251	10446
430206	충청북도	청주시흥덕구	복대제2동	13414	8923	3724	4724	223	10	101	3	2	3	6	12	2	7	8817	106	4491
430207	충청북도	청주시흥덕구	가경동	39293	28306	13278	13585	851	13	248	6	4	3	30	20	7	7	28052	254	10987
430208	충청북도	청주시흥덕구	봉명제1동	8403	5361	2352	2702	152	2	77	1	2	1	2	9	2	2	5304	57	3042
430209	충청북도	청주시흥덕구	봉명제2·송정동	19018	12301	5546	6068	339	8	164	5	3	2	5	10	9	2	12161	140	6717
430210	충청북도	청주시흥덕구	강서제1동	23262	16419	7696	7866	503	10	177	4	1	5	7	5	5	5	16284	135	6843
430211	충청북도	청주시흥덕구	강서제2동	9243	6959	3421	3132	237	5	73	1	0	3	3	3	2	3	6883	76	2284
430301	충청북도	충주시	주덕읍	4461	3323	1274	1894	75	2	24	3	0	2	0	3	4	4	3285	38	1138
430302	충청북도	충주시	살미면	1951	1564	574	929	33	1	10	1	0	1	3	0	1	1	1554	10	387
430303	충청북도	충주시	수안보면	2654	2071	704	1275	28	3	23	1	0	2	3	6	4	3	2052	19	583
430304	충청북도	충주시	대소원면	7641	5236	2373	2585	101	7	90	1	2	1	9	3	9	3	5184	52	2405
430305	충청북도	충주시	신니면	2725	2105	750	1250	51	3	20	1	0	0	2	1	2	0	2080	25	620
430306	충청북도	충주시	노은면	2097	1619	610	961	19	2	8	0	0	0	0	0	1	1	1602	17	478
430307	충청북도	충주시	앙성면	3455	2576	874	1616	42	1	17	0	1	2	2	2	0	3	2560	16	879
430308	충청북도	충주시	중앙탑면	9429	6484	3142	3031	174	2	68	1	1	0	4	5	0	4	6432	52	2945
430309	충청북도	충주시	금가면	3300	2512	1019	1347	75	3	28	0	0	2	3	1	2	1	2481	31	788
430310	충청북도	충주시	동량면	3141	2385	843	1427	50	2	20	3	0	0	1	9	4	5	2364	21	756
430311	충청북도	충주시	산척면	2253	1840	643	1132	32	1	12	4	0	0	2	2	5	1	1834	6	413
430312	충청북도	충주시	엄정면	2867	2228	716	1403	34	2	34	2	1	1	2	1	6	4	2206	22	639
430313	충청북도	충주시	소태면	1506	1185	418	733	14	0	4	0	0	0	1	2	2	0	1174	11	321
430314	충청북도	충주시	성내·충인동	3119	2424	795	1547	32	1	26	1	1	0	2	2	2	1	2410	14	695
430315	충청북도	충주시	교현·안림동	18105	13232	6031	6608	303	6	150	2	4	8	12	10	9	3	13146	86	4873
430316	충청북도	충주시	교현2동	5935	4188	1679	2300	104	3	42	3	0	2	6	2	4	6	4151	37	1747
430317	충청북도	충주시	용산동	11008	7909	3775	3762	190	6	89	0	2	3	8	11	2	7	7855	54	3099
430318	충청북도	충주시	지현동	4469	3371	1459	1733	82	0	47	1	0	2	3	6	3	2	3338	33	1098
430319	충청북도	충주시	문화동	8539	6458	2339	3820	153	1	70	2	0	2	3	2	3	4	6399	59	2081
430320	충청북도	충주시	호암·직동	14132	10487	5353	4566	338	6	113	4	4	2	5	5	2	2	10400	87	3645
430321	충청북도	충주시	달천동	3406	2477	949	1421	43	2	18	3	1	2	2	2	1	0	2444	33	929
430322	충청북도	충주시	봉방동	8237	6198	2603	3320	141	1	63	3	2	1	6	5	6	2	6153	45	2039
430323	충청북도	충주시	칠금·금릉동	12119	9181	4213	4518	246	0	101	2	3	2	9	6	6	4	9110	71	2938
430324	충청북도	충주시	연수동	27597	19467	8626	9893	483	11	202	4	5	9	12	14	9	14	19282	185	8130
430325	충청북도	충주시	목행·용탄동	5279	3949	1899	1848	107	2	55	1	0	0	2	3	6	2	3925	24	1330
430401	충청북도	제천시	봉양읍	5651	4273	1655	2406	90	5	33	2	0	1	2	11	9	10	4224	49	1378
430402	충청북도	제천시	금성면	1786	1404	523	813	20	1	17	1	0	0	1	5	2	1	1384	20	382
430403	충청북도	제천시	청풍면	1144	942	306	596	14	0	10	0	0	0	2	1	2	1	932	10	202
430404	충청북도	제천시	수산면	1777	1381	473	855	22	0	9	0	0	1	2	3	0	1	1366	15	396
430405	충청북도	제천시	덕산면	1815	1452	573	805	27	2	10	0	2	1	3	1	5	3	1432	20	363
430406	충청북도	제천시	한수면	566	431	143	273	9	0	1	1	0	0	0	1	0	0	428	3	135
430407	충청북도	제천시	백운면	2906	2256	791	1356	50	1	18	2	0	1	2	3	3	2	2229	27	650
430408	충청북도	제천시	송학면	4081	3111	1101	1876	48	1	36	0	2	2	2	7	3	1	3079	32	970
430409	충청북도	제천시	교동	13214	9554	4438	4681	219	4	106	1	1	0	10	7	10	8	9485	69	3660
430412	충청북도	제천시	남현동	4384	3264	1202	1920	60	0	40	0	0	1	7	3	6	2	3241	23	1120
430413	충청북도	제천시	영서동	8327	6174	2637	3240	140	2	76	1	0	0	23	5	3	3	6130	44	2153
430414	충청북도	제천시	용두동	13819	10116	4607	5065	209	3	117	5	1	2	6	7	9	5	10036	80	3703
430415	충청북도	제천시	신백동	8994	6517	2822	3314	179	1	100	3	3	4	2	9	6	7	6450	67	2477
430416	충청북도	제천시	청전동	12980	9606	3585	5613	190	4	117	2	2	0	9	9	6	3	9540	66	3374
430417	충청북도	제천시	화산동	11171	8092	3572	4167	181	3	88	1	0	1	11	7	8	8	8047	45	3079
430418	충청북도	제천시	의림지동	8665	6895	3175	3407	168	5	67	3	1	1	4	5	3	3	6842	53	1770
430419	충청북도	제천시	중앙동	5421	4101	1439	2480	77	4	40	1	0	0	4	3	4	5	4057	44	1320
430501	충청북도	단양군	단양읍	8182	6168	2366	3541	129	4	44	1	1	3	8	8	15	9	6129	39	2014
430502	충청북도	단양군	매포읍	4428	3410	1275	1967	59	0	45	2	2	2	7	4	13	4	3380	30	1018
430503	충청북도	단양군	단성면	1399	1057	353	659	20	2	11	0	0	0	1	0	3	0	1049	8	342
430504	충청북도	단양군	대강면	2208	1702	497	1132	32	0	19	0	0	1	1	0	5	1	1688	14	506
430505	충청북도	단양군	가곡면	1729	1363	480	821	22	0	13	0	0	0	3	6	1	3	1349	14	366
430506	충청북도	단양군	영춘면	2691	2074	618	1362	25	1	18	0	0	1	6	5	17	3	2056	18	617
430507	충청북도	단양군	어상천면	1602	1208	436	708	23	2	21	0	0	0	3	1	3	1	1198	10	394
430508	충청북도	단양군	적성면	1139	864	263	558	18	2	7	0	0	0	3	3	3	2	859	5	275
430601	충청북도	청주시청원구	내수읍	14911	10322	4850	4888	281	5	147	2	2	0	11	11	10	8	10215	107	4589
430602	충청북도	청주시청원구	오창읍	47912	34132	18301	14145	980	7	334	5	4	5	17	24	10	12	33844	288	13780
430603	충청북도	청주시청원구	북이면	3909	2821	1051	1618	49	3	29	2	1	2	5	12	4	5	2781	40	1088
430604	충청북도	청주시청원구	우암동	10183	6903	2597	3938	157	6	82	1	1	1	14	10	8	4	6819	84	3280
430605	충청북도	청주시청원구	내덕제1동	8604	6339	2614	3417	154	3	68	4	1	6	5	7	3	2	6284	55	2265
430606	충청북도	청주시청원구	내덕제2동	10731	7746	3416	3928	209	6	74	1	2	2	8	7	6	3	7662	84	2985
430607	충청북도	청주시청원구	율량·사천동	35880	25561	12113	12033	800	10	262	11	5	8	22	25	9	19	25317	244	10319
430608	충청북도	청주시청원구	오근장동	12574	9263	4585	4202	272	5	85	5	0	1	5	7	3	4	9174	89	3311
430701	충청북도	영동군	영동읍	14846	10728	4383	5820	230	2	113	14	1	4	11	16	8	5	10607	121	4118
430702	충청북도	영동군	용산면	2952	2245	831	1314	45	1	27	1	1	1	1	2	4	4	2232	13	707
430703	충청북도	영동군	황간면	3524	2720	951	1646	56	0	38	1	0	0	3	4	1	1	2701	19	804
430704	충청북도	영동군	추풍령면	1895	1469	425	983	21	0	15	1	0	1	2	1	4	2	1455	14	426
430705	충청북도	영동군	매곡면	1590	1199	364	780	24	0	11	0	0	2	0	1	1	2	1185	14	391
430706	충청북도	영동군	상촌면	1914	1494	493	944	24	0	14	0	0	1	0	1	1	2	1480	14	420
430707	충청북도	영동군	양강면	3068	2390	899	1378	48	1	26	1	0	0	1	8	2	2	2366	24	678
430708	충청북도	영동군	용화면	792	619	252	342	10	0	3	0	1	1	1	0	2	1	613	6	173
430709	충청북도	영동군	학산면	2342	1772	648	1054	35	1	13	0	0	0	1	2	2	2	1758	14	570
430710	충청북도	영동군	양산면	1623	1250	441	756	22	0	9	1	0	0	2	1	2	0	1234	16	373
430711	충청북도	영동군	심천면	2644	1998	690	1204	45	2	16	1	0	3	2	3	6	1	1973	25	646
430801	충청북도	보은군	보은읍	11182	8271	3317	4496	192	2	126	1	3	4	11	13	10	4	8179	92	2911
430802	충청북도	보은군	속리산면	1611	1295	481	767	22	0	10	1	1	0	0	3	1	1	1287	8	316
430803	충청북도	보은군	장안면	1293	1014	420	537	26	1	14	1	0	0	2	0	3	4	1008	6	279
430804	충청북도	보은군	마로면	1927	1520	572	865	32	0	17	1	0	0	1	2	2	2	1494	26	407
430805	충청북도	보은군	탄부면	1375	1039	369	613	26	2	6	0	1	0	1	2	7	3	1030	9	336
430806	충청북도	보은군	삼승면	1924	1463	597	788	33	1	18	2	0	2	1	1	4	3	1450	13	461
430807	충청북도	보은군	수한면	1998	1602	605	927	37	1	11	0	0	0	3	1	1	2	1588	14	396
430808	충청북도	보은군	회남면	580	468	136	318	4	1	4	0	1	0	1	0	0	1	466	2	112
430809	충청북도	보은군	회인면	1456	1094	318	726	20	0	8	1	1	0	1	1	2	2	1080	14	362
430810	충청북도	보은군	내북면	1357	1025	384	586	23	2	12	1	0	1	3	1	4	3	1020	5	332
430811	충청북도	보은군	산외면	1482	1173	401	728	19	0	11	0	0	2	0	0	1	1	1163	10	309
430901	충청북도	옥천군	옥천읍	22537	16465	7497	8091	460	10	186	7	1	4	13	17	13	14	16313	152	6072
430902	충청북도	옥천군	동이면	2844	2239	850	1273	48	2	24	1	1	0	7	3	7	3	2219	20	605
430903	충청북도	옥천군	안남면	1237	975	363	552	25	3	11	0	0	1	0	8	0	1	964	11	262
430904	충청북도	옥천군	안내면	1640	1299	382	844	27	3	17	2	0	1	0	7	5	1	1289	10	341
430905	충청북도	옥천군	청성면	1760	1259	414	757	31	4	12	0	0	3	1	14	4	3	1243	16	501
430906	충청북도	옥천군	청산면	2599	2067	678	1285	34	1	16	0	0	1	2	5	9	1	2032	35	532
430907	충청북도	옥천군	이원면	3609	2652	956	1563	58	2	29	0	0	1	2	3	7	1	2622	30	957
430908	충청북도	옥천군	군서면	1943	1508	548	882	34	1	18	1	0	0	2	4	2	1	1493	15	435
430909	충청북도	옥천군	군북면	2512	1848	684	1069	47	1	14	3	0	0	3	2	8	2	1833	15	664
431001	충청북도	음성군	음성읍	13616	9749	4311	4982	228	4	95	4	2	4	9	14	4	8	9665	84	3867
431002	충청북도	음성군	금왕읍	15588	10738	5193	5031	222	5	152	1	1	8	5	11	4	8	10641	97	4850
431003	충청북도	음성군	소이면	2505	1929	775	1047	52	3	20	1	1	0	0	6	3	2	1910	19	576
431004	충청북도	음성군	원남면	2529	1859	700	1092	27	2	9	0	0	0	1	1	2	4	1838	21	670
431005	충청북도	음성군	맹동면	9302	6070	3205	2526	182	3	62	3	1	3	5	7	6	4	6007	63	3232
431006	충청북도	음성군	대소면	12255	8129	3998	3744	175	5	112	3	3	4	5	5	2	5	8061	68	4126
431007	충청북도	음성군	삼성면	5690	3921	1585	2164	65	0	58	1	3	3	3	2	5	3	3892	29	1769
431008	충청북도	음성군	생극면	4015	2984	1215	1617	52	4	27	3	0	2	3	1	4	2	2930	54	1031
431009	충청북도	음성군	감곡면	8094	5693	2343	3099	107	2	55	4	2	3	4	5	6	5	5635	58	2401
431101	충청북도	진천군	진천읍	24038	16821	8068	7821	467	14	223	6	4	5	13	27	9	11	16668	153	7217
431103	충청북도	진천군	초평면	2663	2022	865	1056	40	1	21	1	0	0	1	8	3	4	2000	22	641
431104	충청북도	진천군	문백면	2970	2176	858	1187	59	2	31	0	1	1	0	4	2	2	2147	29	794
431105	충청북도	진천군	백곡면	1852	1473	512	891	35	1	17	0	0	1	1	1	2	1	1462	11	379
431106	충청북도	진천군	이월면	5382	3839	1609	2031	92	1	43	0	0	1	2	6	1	4	3790	49	1543
431107	충청북도	진천군	광혜원면	8259	5736	2807	2664	130	6	68	3	1	3	2	8	3	4	5699	37	2523
431108	충청북도	진천군	덕산읍	19975	13752	7623	5438	374	4	166	2	2	4	5	15	9	4	13646	106	6223
431201	충청북도	괴산군	괴산읍	7730	5810	2482	3076	116	4	59	4	0	1	1	6	3	4	5756	54	1920
431202	충청북도	괴산군	감물면	1661	1262	394	818	20	0	4	0	0	0	2	5	3	0	1246	16	399
431203	충청북도	괴산군	장연면	1480	1102	353	706	18	2	7	0	0	0	0	5	5	0	1096	6	378
431204	충청북도	괴산군	연풍면	2023	1562	480	1018	22	2	16	0	0	0	0	2	1	7	1548	14	461
431205	충청북도	괴산군	칠성면	2670	2095	773	1227	42	2	20	1	1	3	0	1	2	2	2074	21	575
431206	충청북도	괴산군	문광면	2069	1618	634	903	37	0	17	0	0	1	1	2	5	1	1601	17	451
431207	충청북도	괴산군	청천면	4117	3185	1032	2010	57	5	22	6	4	4	7	2	4	5	3158	27	932
431208	충청북도	괴산군	청안면	2695	1977	673	1225	38	2	13	0	0	0	1	4	3	3	1962	15	718
431209	충청북도	괴산군	사리면	2248	1688	573	1034	35	2	11	1	0	0	3	3	0	3	1665	23	560
431210	충청북도	괴산군	소수면	1718	1292	556	662	31	1	26	2	0	1	4	0	1	0	1284	8	426
431211	충청북도	괴산군	불정면	2333	1782	599	1116	27	0	17	1	1	1	4	1	1	1	1769	13	551
431301	충청북도	증평군	증평읍	26413	18553	8359	9284	441	6	216	4	8	4	23	12	14	9	18380	173	7860
431302	충청북도	증평군	도안면	1795	1383	566	749	26	0	17	1	0	1	1	4	4	0	1369	14	412
431401	충청북도	청주시서원구	남이면	7655	5645	2321	3081	132	4	48	4	4	0	1	6	4	4	5609	36	2010
431402	충청북도	청주시서원구	현도면	2645	1922	632	1192	36	2	22	1	0	2	4	1	4	5	1901	21	723
431403	충청북도	청주시서원구	사직제1동	5325	3791	1478	2130	95	2	40	1	1	2	5	1	0	1	3756	35	1534
431404	충청북도	청주시서원구	사직제2동	9445	7185	3023	3875	152	2	53	1	2	1	3	4	1	3	7120	65	2260
431405	충청북도	청주시서원구	사창동	14546	10501	4237	5680	302	6	105	4	3	3	9	7	0	4	10360	141	4045
431406	충청북도	청주시서원구	모충동	12461	8555	3455	4616	234	7	97	3	2	2	4	9	4	2	8435	120	3906
431407	충청북도	청주시서원구	산남동	18486	13827	6831	6386	371	6	88	4	1	1	3	4	1	6	13702	125	4659
431408	충청북도	청주시서원구	분평동	23089	17308	8446	7942	538	13	143	10	7	1	11	23	3	7	17144	164	5781
431409	충청북도	청주시서원구	수곡제1동	11145	7780	3217	4109	218	9	111	3	1	1	2	11	7	6	7695	85	3365
431410	충청북도	청주시서원구	수곡제2동	13078	9659	4168	4967	260	8	98	4	0	1	6	3	5	7	9527	132	3419
431411	충청북도	청주시서원구	성화·개신·죽림동	30945	22356	10857	10323	659	18	212	11	4	6	11	31	5	8	22145	211	8589
440201	충청남도	공주시	유구읍	6195	4544	1403	2966	60	3	48	0	0	1	5	6	5	2	4499	45	1651
440202	충청남도	공주시	이인면	2717	2002	748	1184	18	1	19	0	1	0	0	3	6	0	1980	22	715
440203	충청남도	공주시	탄천면	2507	1776	624	1048	40	2	15	2	0	2	4	3	4	1	1745	31	731
440204	충청남도	공주시	계룡면	4433	3253	1178	1973	41	0	30	0	0	0	1	1	0	0	3224	29	1180
440205	충청남도	공주시	반포면	3494	2587	900	1572	46	4	27	3	3	0	1	2	2	0	2560	27	907
440207	충청남도	공주시	의당면	4303	3190	1391	1671	55	1	31	1	0	0	3	7	2	1	3163	27	1113
440208	충청남도	공주시	정안면	3908	2855	1065	1676	41	4	28	2	0	0	8	1	6	1	2832	23	1053
440209	충청남도	공주시	우성면	4375	3299	1218	1961	57	0	23	2	1	0	2	6	1	5	3276	23	1076
440210	충청남도	공주시	사곡면	2338	1711	581	1071	25	2	13	0	0	1	1	3	1	2	1700	11	627
440211	충청남도	공주시	신풍면	2508	1858	633	1155	35	1	11	1	0	1	2	2	4	1	1846	12	650
440212	충청남도	공주시	중학동	4084	2988	1239	1623	56	2	30	1	0	1	3	3	3	2	2963	25	1096
440214	충청남도	공주시	웅진동	7192	5327	2190	2909	111	1	50	2	0	2	3	7	4	3	5282	45	1865
440215	충청남도	공주시	금학동	4087	2881	1251	1479	78	3	37	1	0	0	0	2	1	3	2855	26	1206
440216	충청남도	공주시	옥룡동	6614	4713	1816	2694	86	2	48	1	0	1	6	4	2	7	4667	46	1901
440217	충청남도	공주시	신관동	13936	9673	4365	4833	245	4	110	2	0	3	6	15	3	5	9591	82	4263
440218	충청남도	공주시	월송동	11069	8410	4108	3928	217	5	75	2	0	2	6	16	2	3	8364	46	2659
440301	충청남도	보령시	웅천읍	5232	4005	1370	2476	55	2	37	1	1	0	2	4	8	8	3964	41	1227
440302	충청남도	보령시	주포면	1451	1153	412	681	23	1	15	0	0	2	0	3	1	2	1140	13	298
440303	충청남도	보령시	주교면	4323	3093	1216	1666	63	6	22	2	6	3	3	2	4	15	3008	85	1230
440304	충청남도	보령시	오천면	3616	2602	854	1631	44	3	16	1	0	0	1	7	3	4	2564	38	1014
440305	충청남도	보령시	천북면	2839	2115	730	1297	35	0	14	0	0	1	3	2	5	4	2091	24	724
440306	충청남도	보령시	청소면	2293	1733	520	1123	34	1	22	2	1	0	3	1	2	1	1710	23	560
440307	충청남도	보령시	청라면	3224	2477	811	1559	43	2	27	0	0	0	3	5	3	0	2453	24	747
440308	충청남도	보령시	남포면	4379	3210	1104	1989	46	2	29	1	0	2	2	4	4	3	3186	24	1169
440309	충청남도	보령시	주산면	2079	1603	530	1002	33	0	14	0	0	0	1	4	3	2	1589	14	476
440310	충청남도	보령시	미산면	1376	1053	349	651	17	2	12	1	0	0	5	1	1	4	1043	10	323
440311	충청남도	보령시	성주면	2111	1639	639	912	35	0	22	0	0	2	3	1	3	1	1618	21	472
440312	충청남도	보령시	대천1동	10559	7676	3076	4246	169	3	82	4	1	1	8	21	4	2	7617	59	2883
440313	충청남도	보령시	대천2동	6765	5349	2090	3043	105	2	47	3	0	0	2	12	3	1	5308	41	1416
440314	충청남도	보령시	대천3동	10995	7869	3656	3805	222	0	83	2	2	2	4	14	2	3	7795	74	3126
440315	충청남도	보령시	대천4동	12805	9528	4392	4732	205	3	102	4	2	1	4	11	2	8	9466	62	3277
440316	충청남도	보령시	대천5동	5508	4006	1459	2400	57	1	38	0	0	3	8	4	3	2	3975	31	1502
440401	충청남도	아산시	염치읍	5516	3801	1604	2022	85	4	48	0	0	4	1	4	4	1	3777	24	1715
440402	충청남도	아산시	배방읍	55763	39294	20982	16333	1140	18	401	9	6	5	21	42	7	12	38976	318	16469
440403	충청남도	아산시	송악면	3536	2697	1129	1451	63	1	19	5	0	1	1	2	1	3	2676	21	839
440404	충청남도	아산시	탕정면	18245	13687	7253	5795	354	4	146	14	0	0	7	8	2	3	13586	101	4558
440405	충청남도	아산시	음봉면	14405	9795	4766	4547	224	4	142	2	2	2	12	5	5	4	9715	80	4610
440406	충청남도	아산시	둔포면	17483	11328	5443	5373	246	9	134	5	2	3	4	7	4	6	11236	92	6155
440407	충청남도	아산시	영인면	5051	3792	1519	2075	70	4	37	3	2	0	2	5	2	2	3721	71	1259
440408	충청남도	아산시	인주면	5252	3757	1705	1872	83	4	44	4	1	1	2	2	1	1	3720	37	1495
440409	충청남도	아산시	선장면	2737	2049	676	1297	34	2	14	0	0	1	1	2	1	4	2032	17	688
440410	충청남도	아산시	도고면	4136	3104	1091	1891	54	0	26	1	0	1	0	2	3	3	3072	32	1032
440411	충청남도	아산시	신창면	14710	9750	4396	4860	232	2	143	4	3	5	9	7	5	6	9672	78	4960
440412	충청남도	아산시	온양1동	8204	5899	2696	2939	137	3	61	4	1	1	8	6	1	0	5857	42	2305
440413	충청남도	아산시	온양2동	10606	7457	3084	4025	166	2	81	1	3	5	3	5	2	1	7378	79	3149
440414	충청남도	아산시	온양3동	26835	19114	9105	9071	530	11	188	6	0	4	9	23	5	8	18960	154	7721
440415	충청남도	아산시	온양4동	14221	9887	4630	4765	257	8	112	4	4	2	6	15	2	4	9809	78	4334
440416	충청남도	아산시	온양5동	15841	11050	5376	5111	315	3	129	4	2	2	8	7	1	1	10959	91	4791
440417	충청남도	아산시	온양6동	20640	14782	7385	6648	403	6	182	5	2	2	11	6	4	4	14658	124	5858
440501	충청남도	서산시	대산읍	11017	7923	3698	3841	182	4	97	4	2	1	3	12	5	5	7854	69	3094
440502	충청남도	서산시	인지면	6234	4668	2008	2458	95	2	54	3	0	1	0	5	4	3	4633	35	1566
440503	충청남도	서산시	부석면	4614	3312	1226	1940	68	1	26	2	1	1	1	4	3	4	3277	35	1302
440504	충청남도	서산시	팔봉면	2914	2228	812	1327	38	1	14	1	0	0	5	3	3	3	2207	21	686
440505	충청남도	서산시	지곡면	6458	4524	1982	2321	90	1	64	1	1	1	1	15	2	4	4483	41	1934
440506	충청남도	서산시	성연면	10650	7716	4275	3036	206	5	107	2	2	0	6	6	3	5	7653	63	2934
440507	충청남도	서산시	음암면	7457	5185	2165	2726	113	6	73	5	1	2	5	14	6	6	5122	63	2272
440508	충청남도	서산시	운산면	4355	3230	1149	1938	60	6	22	1	1	0	3	7	5	6	3198	32	1125
440509	충청남도	서산시	해미면	6760	4915	1865	2828	98	4	60	3	3	2	6	3	5	4	4881	34	1845
440510	충청남도	서산시	고북면	4604	3185	1242	1793	72	2	22	0	0	1	4	5	4	4	3149	36	1419
440511	충청남도	서산시	부춘동	16013	11505	5065	5876	294	4	134	6	3	3	4	10	6	6	11411	94	4508
440512	충청남도	서산시	동문1동	13403	9487	4126	4954	249	2	83	5	1	1	4	2	1	5	9433	54	3916
440513	충청남도	서산시	동문2동	7438	5317	2170	2890	127	3	64	4	1	1	5	3	0	0	5268	49	2121
440514	충청남도	서산시	수석동	12213	8752	3902	4401	241	4	103	3	1	2	5	3	6	6	8677	75	3461
440515	충청남도	서산시	석남동	23723	16856	8297	7736	440	8	199	14	0	2	12	9	3	3	16723	133	6867
440601	충청남도	태안군	태안읍	23052	16737	6913	9082	377	5	150	9	1	5	15	21	16	9	16603	134	6315
440602	충청남도	태안군	안면읍	7014	5176	2059	2926	73	4	47	0	1	3	4	5	8	8	5138	38	1838
440603	충청남도	태안군	고남면	1949	1438	588	794	25	0	8	0	0	1	1	1	4	1	1423	15	511
440604	충청남도	태안군	남면	3639	2739	1068	1549	57	4	18	1	1	2	2	3	2	3	2710	29	900
440605	충청남도	태안군	근흥면	4602	3424	1201	2096	50	0	15	3	0	0	0	5	6	7	3383	41	1178
440606	충청남도	태안군	소원면	4649	3476	1259	2078	71	0	15	2	0	0	2	4	7	8	3446	30	1173
440607	충청남도	태안군	원북면	3692	2798	981	1705	50	1	11	0	0	2	1	3	7	2	2763	35	894
440608	충청남도	태안군	이원면	1808	1385	492	831	39	0	3	0	0	0	2	2	2	4	1375	10	423
440701	충청남도	금산군	금산읍	17894	13026	5825	6619	274	5	121	2	2	3	10	25	12	8	12906	120	4868
440702	충청남도	금산군	금성면	2738	1950	782	1082	32	2	22	1	1	2	2	0	2	1	1929	21	788
440703	충청남도	금산군	제원면	2375	1746	617	1052	23	1	17	0	1	2	0	0	3	4	1720	26	629
440704	충청남도	금산군	부리면	2032	1470	533	872	22	2	17	0	0	1	2	1	4	2	1456	14	562
440705	충청남도	금산군	군북면	1894	1413	522	814	24	1	21	0	0	0	1	5	6	3	1397	16	481
440706	충청남도	금산군	남일면	2199	1651	626	955	25	2	14	1	1	0	0	1	4	2	1631	20	548
440707	충청남도	금산군	남이면	1577	1111	467	595	22	0	6	0	0	0	1	3	2	6	1102	9	466
440708	충청남도	금산군	진산면	2529	1880	693	1114	31	2	15	2	0	0	1	1	3	3	1865	15	649
440709	충청남도	금산군	복수면	2489	1874	640	1154	29	2	23	0	0	1	3	2	1	1	1856	18	615
440710	충청남도	금산군	추부면	5061	3612	1504	1954	71	3	26	1	1	3	1	5	5	5	3579	33	1449
440901	충청남도	논산시	강경읍	6910	4908	2632	2094	86	2	47	0	0	1	1	3	5	4	4875	33	2002
440902	충청남도	논산시	연무읍	10848	7520	3652	3507	165	3	93	3	0	3	1	12	4	9	7452	68	3328
440903	충청남도	논산시	성동면	3562	2545	1026	1427	36	2	22	0	0	0	0	1	3	0	2517	28	1017
440904	충청남도	논산시	광석면	3673	2720	1052	1568	49	0	20	3	0	1	1	3	7	1	2705	15	953
440905	충청남도	논산시	노성면	2426	1786	612	1112	31	1	15	0	0	0	3	1	2	1	1778	8	640
440906	충청남도	논산시	상월면	3056	2210	978	1100	47	3	19	0	0	2	2	14	5	2	2172	38	846
440907	충청남도	논산시	부적면	3282	2524	1114	1301	53	1	22	1	1	0	6	6	1	2	2508	16	758
440908	충청남도	논산시	연산면	5328	3843	1440	2251	65	3	26	1	2	1	7	4	7	1	3808	35	1485
440909	충청남도	논산시	벌곡면	2051	1531	571	902	20	3	11	2	0	1	1	2	3	5	1521	10	520
440910	충청남도	논산시	양촌면	4610	3325	1322	1848	65	1	42	0	1	2	4	7	6	4	3302	23	1285
440911	충청남도	논산시	가야곡면	3015	2197	884	1219	34	0	26	0	2	0	3	4	5	2	2179	18	818
440912	충청남도	논산시	은진면	3693	2673	1198	1321	69	1	37	0	0	0	5	8	3	5	2647	26	1020
440913	충청남도	논산시	채운면	2017	1567	726	772	28	1	11	0	0	1	1	3	5	4	1552	15	450
440914	충청남도	논산시	취암동	26245	18349	9071	8419	434	5	217	3	2	3	19	21	9	3	18206	143	7896
440915	충청남도	논산시	부창동	11858	8215	3933	3893	195	4	78	3	1	5	7	11	8	2	8140	75	3643
441001	충청남도	계룡시	두마면	5711	4555	1993	2379	102	5	44	0	1	4	2	1	0	0	4531	24	1156
441002	충청남도	계룡시	엄사면	13388	10008	4410	5093	290	7	97	5	2	6	3	20	4	4	9941	67	3380
441003	충청남도	계룡시	신도안면	5130	4179	1505	2441	148	1	37	0	1	0	0	1	0	3	4137	42	951
441004	충청남도	계룡시	금암동	6327	5107	2230	2670	137	4	27	0	0	2	7	4	0	3	5084	23	1220
441101	충청남도	부여군	부여읍	16046	11971	4489	6997	238	6	101	2	1	7	3	20	9	6	11879	92	4075
441102	충청남도	부여군	규암면	8708	6232	2550	3355	146	3	95	1	0	2	4	13	2	3	6174	58	2476
441103	충청남도	부여군	은산면	3211	2437	830	1506	40	1	23	1	1	1	0	6	8	3	2420	17	774
441104	충청남도	부여군	외산면	2037	1582	553	959	29	3	12	0	0	1	2	1	3	1	1564	18	455
441105	충청남도	부여군	내산면	1306	996	362	610	17	0	3	0	0	0	0	0	2	0	994	2	310
441106	충청남도	부여군	구룡면	2090	1523	601	854	38	0	13	0	0	0	1	4	2	0	1513	10	567
441107	충청남도	부여군	홍산면	2568	2007	748	1159	40	2	15	2	1	1	2	16	2	4	1992	15	561
441108	충청남도	부여군	옥산면	1239	974	344	586	8	2	11	0	0	0	2	7	2	4	966	8	265
441109	충청남도	부여군	남면	1586	1198	419	739	15	0	7	0	0	0	0	4	2	0	1186	12	388
441110	충청남도	부여군	충화면	978	729	266	432	12	0	7	1	0	0	1	2	1	2	724	5	249
441111	충청남도	부여군	양화면	1451	1106	381	678	14	0	5	3	0	1	1	2	6	2	1093	13	345
441112	충청남도	부여군	임천면	2398	1757	628	1050	26	2	17	1	0	0	4	2	4	2	1736	21	641
441113	충청남도	부여군	장암면	2349	1687	567	1054	26	0	15	1	0	0	1	3	3	3	1673	14	662
441114	충청남도	부여군	세도면	2701	2040	818	1129	35	2	22	1	0	1	3	4	4	4	2023	17	661
441115	충청남도	부여군	석성면	2406	1790	687	1029	30	1	18	1	0	1	5	3	2	1	1778	12	616
441116	충청남도	부여군	초촌면	1765	1291	450	767	35	0	11	1	0	0	2	8	1	4	1279	12	474
441201	충청남도	서천군	장항읍	9099	6606	3147	3197	122	3	49	2	1	2	2	9	5	6	6545	61	2493
441202	충청남도	서천군	서천읍	10742	8172	3610	4215	185	3	59	1	2	2	10	10	7	13	8117	55	2570
441203	충청남도	서천군	마서면	3946	2787	1199	1483	45	2	17	0	0	0	0	9	3	5	2763	24	1159
441204	충청남도	서천군	화양면	1888	1438	589	782	24	1	19	1	1	0	1	4	5	2	1429	9	450
441205	충청남도	서천군	기산면	1382	1019	415	558	18	0	6	1	1	0	1	2	4	2	1008	11	363
441206	충청남도	서천군	한산면	2200	1710	742	892	29	1	11	0	0	1	1	6	4	3	1690	20	490
441207	충청남도	서천군	마산면	1242	914	378	493	16	0	7	1	0	1	1	9	1	2	909	5	328
441208	충청남도	서천군	시초면	1045	793	284	468	17	1	6	0	0	1	0	1	2	1	781	12	252
441209	충청남도	서천군	문산면	1124	864	317	513	13	0	7	0	0	0	1	5	2	0	858	6	260
441210	충청남도	서천군	판교면	1827	1443	476	908	20	3	7	0	2	1	3	3	3	1	1427	16	384
441211	충청남도	서천군	종천면	1776	1318	537	719	23	0	11	0	1	1	0	1	4	4	1301	17	458
441212	충청남도	서천군	비인면	2575	1907	818	994	47	3	11	2	0	2	3	5	2	2	1889	18	668
441213	충청남도	서천군	서면	3487	2570	1147	1321	48	2	18	3	0	0	1	4	5	3	2552	18	917
441301	충청남도	홍성군	홍성읍	29056	19835	8160	10791	470	10	188	3	0	2	15	12	10	11	19672	163	9221
441302	충청남도	홍성군	광천읍	7402	5343	1738	3409	64	2	61	6	0	3	5	1	8	5	5302	41	2059
441304	충청남도	홍성군	금마면	3251	2434	927	1396	47	0	24	2	0	0	1	0	4	4	2405	29	817
441305	충청남도	홍성군	홍동면	3071	2358	1050	1184	72	1	17	11	0	0	2	3	2	1	2343	15	713
441306	충청남도	홍성군	장곡면	2512	1831	589	1154	37	0	22	2	0	0	1	1	5	2	1813	18	681
441307	충청남도	홍성군	은하면	2035	1476	451	962	28	0	12	0	0	0	0	1	4	0	1458	18	559
441308	충청남도	홍성군	결성면	1868	1417	381	970	29	1	9	0	1	0	4	3	5	2	1405	12	451
441309	충청남도	홍성군	서부면	2848	2105	672	1340	36	3	24	0	1	0	1	4	2	4	2087	18	743
441310	충청남도	홍성군	갈산면	3269	2474	775	1610	33	1	13	0	1	0	1	8	4	3	2449	25	795
441311	충청남도	홍성군	구항면	3577	2706	1144	1446	51	1	24	1	0	0	1	7	5	1	2681	25	871
441312	충청남도	홍성군	홍북읍	18475	13503	6862	5983	434	3	111	1	2	3	5	10	8	9	13431	72	4972
441401	충청남도	청양군	청양읍	7936	6019	2147	3611	114	5	65	3	0	1	1	13	5	3	5968	51	1917
441402	충청남도	청양군	운곡면	1786	1353	364	936	25	4	13	1	1	0	0	1	2	0	1347	6	433
441403	충청남도	청양군	대치면	1863	1432	457	906	34	2	13	1	0	0	0	1	2	0	1416	16	431
441404	충청남도	청양군	정산면	2964	2211	812	1302	43	4	21	0	2	0	1	4	6	1	2196	15	753
441405	충청남도	청양군	목면	1170	876	320	515	11	0	17	1	0	1	0	1	0	0	866	10	294
441406	충청남도	청양군	청남면	1575	1160	354	767	13	2	8	0	0	0	1	2	2	1	1150	10	415
441407	충청남도	청양군	장평면	1892	1431	509	869	25	1	9	0	0	0	2	2	1	6	1424	7	461
441408	충청남도	청양군	남양면	2268	1640	582	966	29	2	23	0	1	0	2	2	1	5	1613	27	628
441409	충청남도	청양군	화성면	1828	1397	475	852	31	1	16	0	1	1	2	2	2	0	1383	14	431
441410	충청남도	청양군	비봉면	1695	1313	491	774	14	1	12	0	1	0	0	2	2	2	1299	14	382
441501	충청남도	예산군	예산읍	25250	17851	5995	11098	364	12	172	6	1	4	20	21	7	4	17704	147	7399
441502	충청남도	예산군	삽교읍	7512	5137	1647	3242	103	1	65	2	1	0	5	4	6	6	5082	55	2375
441503	충청남도	예산군	대술면	2228	1662	521	1065	34	1	19	0	0	0	0	1	4	2	1647	15	566
441504	충청남도	예산군	신양면	2665	2015	532	1414	27	2	14	0	0	0	0	7	4	2	2002	13	650
441505	충청남도	예산군	광시면	2657	1931	490	1347	35	0	14	0	1	2	1	3	6	3	1902	29	726
441506	충청남도	예산군	대흥면	1454	1084	269	764	23	2	8	1	0	0	1	1	2	0	1071	13	370
441507	충청남도	예산군	응봉면	2264	1682	505	1090	33	0	30	0	0	0	3	3	1	1	1666	16	582
441508	충청남도	예산군	덕산면	5772	4197	1375	2649	77	0	44	1	1	1	3	7	3	2	4163	34	1575
441509	충청남도	예산군	봉산면	1943	1410	382	953	26	1	14	0	1	0	1	9	1	3	1391	19	533
441510	충청남도	예산군	고덕면	3888	2840	915	1819	47	2	14	0	1	1	4	11	3	2	2819	21	1048
441511	충청남도	예산군	신암면	3520	2697	876	1689	57	0	32	1	1	0	2	6	2	2	2668	29	823
441512	충청남도	예산군	오가면	3878	2869	847	1893	57	2	32	1	0	0	3	8	1	1	2845	24	1009
441601	충청남도	당진시	당진1동	18337	12264	5740	5915	312	2	150	3	1	2	5	19	4	2	12155	109	6073
441602	충청남도	당진시	합덕읍	7757	5513	2086	3195	99	0	59	2	0	1	2	6	4	2	5456	57	2244
441603	충청남도	당진시	송악읍	22543	15272	7977	6622	327	4	190	5	1	1	10	19	5	6	15167	105	7271
441604	충청남도	당진시	고대면	5400	4154	1789	2192	71	1	51	1	0	0	0	4	2	4	4115	39	1246
441605	충청남도	당진시	석문면	7552	5126	2369	2522	87	3	73	2	0	1	6	14	4	6	5087	39	2426
441606	충청남도	당진시	대호지면	2012	1448	487	900	20	1	12	1	0	1	1	4	1	4	1432	16	564
441607	충청남도	당진시	정미면	2984	2151	730	1340	35	0	19	0	0	0	1	4	2	3	2134	17	833
441608	충청남도	당진시	면천면	3101	2317	819	1407	42	1	14	1	1	0	3	6	2	1	2297	20	784
441609	충청남도	당진시	순성면	4347	3090	1237	1706	72	0	27	2	0	1	3	4	5	4	3061	29	1257
441610	충청남도	당진시	우강면	4340	3081	1093	1853	71	0	31	0	0	0	3	4	0	1	3056	25	1259
441611	충청남도	당진시	신평면	12181	8813	4059	4369	190	1	101	2	0	4	13	11	2	5	8757	56	3368
441612	충청남도	당진시	송산면	9417	6604	3345	2945	137	2	92	8	1	3	3	10	0	1	6547	57	2813
441613	충청남도	당진시	당진2동	15902	11020	5623	4842	293	5	111	6	3	7	12	20	7	5	10934	86	4882
441614	충청남도	당진시	당진3동	13461	9992	5029	4501	274	2	82	6	4	1	4	13	3	7	9926	66	3469
441701	충청남도	천안시서북구	성환읍	20015	14175	6026	7397	351	9	176	8	4	2	25	12	5	11	14026	149	5840
441702	충청남도	천안시서북구	성거읍	15510	10308	5003	4738	285	9	146	4	2	3	7	8	4	4	10213	95	5202
441703	충청남도	천안시서북구	직산읍	17468	12097	5868	5624	270	12	177	3	0	1	8	19	4	7	11993	104	5371
441704	충청남도	천안시서북구	입장면	7608	5497	2274	2960	124	3	72	0	0	2	2	8	1	4	5450	47	2111
441705	충청남도	천안시서북구	성정1동	13967	8602	3447	4711	184	5	133	3	2	2	13	9	6	5	8520	82	5365
441706	충청남도	천안시서북구	성정2동	22433	12072	5605	5698	344	14	219	1	1	1	9	13	4	6	11915	157	10361
441707	충청남도	천안시서북구	쌍용1동	11232	7959	3517	4024	225	8	104	1	2	1	5	6	2	4	7899	60	3273
441708	충청남도	천안시서북구	쌍용2동	26774	19373	9320	9051	580	7	183	6	2	1	14	14	5	8	19191	182	7401
441709	충청남도	천안시서북구	쌍용3동	15635	11730	5657	5528	313	7	90	3	0	1	3	11	0	10	11623	107	3905
441710	충청남도	천안시서북구	백석동	27559	20682	10896	8890	540	13	140	4	3	4	9	11	9	3	20522	160	6877
441712	충청남도	천안시서북구	부성1동	35750	23770	11792	10586	771	13	270	8	4	5	12	22	7	11	23501	269	11980
441713	충청남도	천안시서북구	부성2동	41235	28543	15046	11928	845	19	371	8	1	6	5	14	5	9	28257	286	12692
441715	충청남도	천안시서북구	불당1동	23048	17627	8876	7922	502	7	126	3	1	5	4	10	2	6	17464	163	5421
441716	충청남도	천안시서북구	불당2동	23995	18663	9153	8691	527	6	113	3	5	0	6	10	1	1	18516	147	5332
441801	충청남도	천안시동남구	목천읍	18589	12506	6017	5841	312	5	170	2	2	4	13	15	7	6	12394	112	6083
441802	충청남도	천안시동남구	풍세면	3883	2887	1078	1686	67	0	23	1	0	0	3	2	2	8	2870	17	996
441803	충청남도	천안시동남구	광덕면	3718	2768	922	1750	45	0	23	0	0	5	2	4	1	2	2754	14	950
441804	충청남도	천안시동남구	북면	3365	2218	804	1282	51	3	37	2	2	1	0	3	2	6	2193	25	1147
441805	충청남도	천안시동남구	성남면	3037	2286	865	1322	42	1	25	2	0	1	0	2	2	3	2265	21	751
441806	충청남도	천안시동남구	수신면	2195	1660	619	981	24	2	16	2	0	2	2	2	0	0	1650	10	535
441807	충청남도	천안시동남구	병천면	5680	4113	1627	2319	82	0	39	1	0	4	4	4	5	2	4087	26	1567
441808	충청남도	천안시동남구	동면	1841	1338	433	845	25	0	13	2	0	1	0	2	3	1	1325	13	503
441809	충청남도	천안시동남구	중앙동	5176	3688	1337	2199	66	1	48	2	1	0	2	2	0	1	3659	29	1488
441810	충청남도	천안시동남구	문성동	3993	2855	1174	1541	74	3	32	1	1	2	0	2	1	0	2831	24	1138
441811	충청남도	천안시동남구	원성1동	7744	5496	2218	3040	103	4	69	1	1	1	4	4	3	4	5452	44	2248
441812	충청남도	천안시동남구	원성2동	8595	6108	2424	3417	125	5	72	1	1	0	5	3	2	2	6057	51	2487
441813	충청남도	천안시동남구	봉명동	14166	9138	4068	4591	246	8	133	1	0	3	6	5	1	2	9064	74	5028
441814	충청남도	천안시동남구	일봉동	15064	10500	4767	5229	268	5	116	2	2	1	10	10	5	5	10420	80	4564
441815	충청남도	천안시동남구	신방동	33613	23802	12562	10060	666	9	267	8	3	4	7	17	3	12	23618	184	9811
441816	충청남도	천안시동남구	청룡동	38198	27124	12994	12761	775	12	289	7	2	4	9	41	5	12	26911	213	11074
441817	충청남도	천안시동남구	신안동	28756	20609	9055	10496	610	12	191	5	4	2	19	12	1	10	20417	192	8147
450101	전라북도	전주시완산구	중앙동	6636	5287	4161	967	82	2	23	0	1	1	5	0	1	2	5245	42	1349
450102	전라북도	전주시완산구	풍남동	3994	3143	2576	473	51	2	16	1	0	1	1	2	1	2	3126	17	851
450103	전라북도	전주시완산구	노송동	8941	6729	5595	943	108	4	26	1	0	2	0	1	4	5	6689	40	2212
450104	전라북도	전주시완산구	완산동	4760	3705	3076	517	48	1	16	3	0	0	3	0	0	3	3667	38	1055
450105	전라북도	전주시완산구	동서학동	5265	4151	3480	553	62	2	19	0	0	0	1	3	1	1	4122	29	1114
450106	전라북도	전주시완산구	서서학동	7236	5661	4796	700	80	0	33	0	1	0	2	3	2	7	5624	37	1575
450107	전라북도	전주시완산구	중화산1동	11603	9309	7534	1497	160	2	43	1	0	1	4	3	4	4	9253	56	2294
450108	전라북도	전주시완산구	중화산2동	14016	10644	8590	1715	183	2	72	3	1	1	1	7	0	2	10577	67	3372
450109	전라북도	전주시완산구	평화1동	11143	8550	7196	1073	123	4	42	4	0	1	2	9	3	11	8468	82	2593
450110	전라북도	전주시완산구	평화2동	31449	24888	20976	3214	362	12	149	1	7	2	3	7	5	3	24741	147	6561
450111	전라북도	전주시완산구	서신동	28743	22621	18436	3468	401	7	115	6	0	0	4	16	6	6	22465	156	6122
450112	전라북도	전주시완산구	삼천1동	8664	6940	5747	981	106	1	46	2	0	3	0	3	0	3	6892	48	1724
450113	전라북도	전주시완산구	삼천2동	11008	8531	7122	1154	112	4	56	2	0	3	3	8	0	6	8470	61	2477
450114	전라북도	전주시완산구	삼천3동	17125	14110	11979	1729	229	3	66	3	2	1	3	4	2	7	14028	82	3015
450115	전라북도	전주시완산구	효자1동	8883	7016	5730	1099	102	2	25	0	0	1	0	4	0	3	6966	50	1867
450116	전라북도	전주시완산구	효자2동	8837	7107	5853	1025	113	3	48	2	2	0	1	1	1	0	7049	58	1730
450117	전라북도	전주시완산구	효자3동	12131	9987	8199	1504	164	4	56	2	1	0	1	2	0	2	9935	52	2144
450118	전라북도	전주시완산구	효자4동	25505	20122	16185	3305	364	7	85	6	1	2	4	8	5	3	19975	147	5383
450120	전라북도	전주시완산구	효자5동	26446	19830	15599	3520	390	9	132	3	1	1	5	9	2	1	19672	158	6616
450201	전라북도	전주시덕진구	진북동	11662	9138	7378	1478	154	4	50	7	1	2	0	1	2	6	9083	55	2524
450202	전라북도	전주시덕진구	인후1동	13363	10645	8706	1621	179	3	55	4	1	0	0	3	1	2	10575	70	2718
450203	전라북도	전주시덕진구	인후2동	9079	6858	5574	1061	113	2	45	0	0	1	1	3	1	3	6804	54	2221
450204	전라북도	전주시덕진구	인후3동	21858	16074	13517	2009	288	5	116	2	0	3	3	12	0	5	15960	114	5784
450205	전라북도	전주시덕진구	덕진동	14391	10793	8648	1768	201	1	61	3	0	0	2	7	1	5	10697	96	3598
450206	전라북도	전주시덕진구	금암1동	7462	5807	4234	1286	134	3	48	1	1	3	1	4	2	5	5722	85	1655
450207	전라북도	전주시덕진구	금암2동	8181	6459	5240	1030	88	2	36	1	1	0	1	7	4	4	6414	45	1722
450208	전라북도	전주시덕진구	팔복동	7056	5446	4639	639	78	2	41	2	1	0	1	1	1	3	5408	38	1610
450209	전라북도	전주시덕진구	우아1동	9387	7195	5783	1182	128	3	40	0	1	3	3	6	0	2	7151	44	2192
450210	전라북도	전주시덕진구	우아2동	12156	9057	7679	1117	133	1	63	3	0	1	3	5	2	3	9010	47	3099
450211	전라북도	전주시덕진구	호성동	15500	12890	10769	1715	223	5	68	2	0	2	0	8	2	6	12800	90	2610
450212	전라북도	전주시덕진구	송천1동	37453	30030	24344	4613	629	4	157	6	1	6	5	32	8	11	29816	214	7423
450213	전라북도	전주시덕진구	송천2동	22440	18754	15832	2387	289	4	102	2	0	1	7	11	3	11	18649	105	3686
450214	전라북도	전주시덕진구	조촌동	10058	7902	6643	999	138	1	56	4	0	1	1	5	1	5	7854	48	2156
450216	전라북도	전주시덕진구	혁신동	13867	12070	9513	2219	222	1	52	1	0	0	1	3	0	2	12014	56	1797
450217	전라북도	전주시덕진구	여의동	19447	15408	12584	2283	311	4	103	2	2	1	3	9	3	11	15316	92	4039
450301	전라북도	군산시	옥구읍	3314	2755	2327	360	32	1	12	3	0	0	1	3	1	4	2744	11	559
450302	전라북도	군산시	옥산면	4333	3608	3012	501	44	2	23	0	0	0	0	3	1	4	3590	18	725
450303	전라북도	군산시	회현면	2586	2120	1777	271	27	1	13	2	1	1	1	2	0	4	2100	20	466
450304	전라북도	군산시	임피면	2332	1855	1575	226	16	2	16	2	0	1	0	1	0	2	1841	14	477
450305	전라북도	군산시	서수면	2210	1724	1414	255	21	1	8	1	0	0	0	0	2	5	1707	17	486
450306	전라북도	군산시	대야면	4392	3467	2924	447	47	0	22	2	1	0	0	2	2	3	3450	17	925
450307	전라북도	군산시	개정면	2452	1967	1620	298	18	3	14	0	0	0	0	1	1	0	1955	12	485
450308	전라북도	군산시	성산면	2758	2288	1887	338	27	1	12	2	0	0	0	3	1	4	2275	13	470
450309	전라북도	군산시	나포면	1894	1490	1234	209	16	2	7	0	0	1	0	2	1	6	1478	12	404
450310	전라북도	군산시	옥도면	2235	1575	1379	159	12	0	9	2	0	0	0	0	0	3	1564	11	660
450311	전라북도	군산시	옥서면	2912	2381	1989	315	35	2	20	0	0	0	0	2	1	2	2366	15	531
450312	전라북도	군산시	해신동	2613	2167	1791	322	30	0	10	1	0	0	1	3	1	1	2160	7	446
450313	전라북도	군산시	월명동	4978	3900	3186	602	56	2	20	0	0	2	1	0	2	3	3874	26	1078
450315	전라북도	군산시	삼학동	6050	5017	4187	732	38	4	30	0	0	0	1	1	0	3	4996	21	1033
450316	전라북도	군산시	신풍동	6021	4622	3849	662	58	0	15	1	0	2	2	3	0	3	4595	27	1399
450318	전라북도	군산시	중앙동	4336	3366	2776	503	46	1	12	0	1	0	0	2	0	3	3344	22	970
450320	전라북도	군산시	흥남동	10517	8219	6791	1205	118	0	38	2	1	0	2	7	5	2	8171	48	2298
450321	전라북도	군산시	조촌동	18575	14679	11930	2326	244	3	92	2	0	0	3	6	3	7	14616	63	3896
450322	전라북도	군산시	경암동	6906	5408	4425	820	72	2	34	0	0	1	0	6	0	3	5363	45	1498
450323	전라북도	군산시	구암동	6646	5299	4346	757	99	1	43	0	0	1	0	5	3	5	5260	39	1347
450324	전라북도	군산시	개정동	3174	2752	2326	356	38	0	10	0	0	0	1	0	0	2	2733	19	422
450325	전라북도	군산시	수송동	34556	26434	21545	4087	441	5	153	6	1	3	4	18	3	6	26272	162	8122
450326	전라북도	군산시	나운1동	10129	7583	6216	1158	93	3	56	1	0	2	4	1	1	5	7540	43	2546
450327	전라북도	군산시	나운2동	18671	14965	12291	2264	194	7	74	4	3	1	5	12	2	11	14868	97	3706
450328	전라북도	군산시	나운3동	20496	14770	11959	2313	230	9	128	2	1	1	5	18	2	10	14678	92	5726
450329	전라북도	군산시	소룡동	14216	10099	8363	1433	110	4	115	0	2	1	1	6	1	11	10047	52	4117
450330	전라북도	군산시	미성동	9175	6378	5380	808	80	2	57	3	0	0	2	5	2	6	6345	33	2797
450501	전라북도	익산시	함열읍	6008	4716	3983	615	59	2	25	0	0	1	0	6	1	4	4696	20	1292
450502	전라북도	익산시	오산면	5707	4298	3671	518	49	0	23	0	1	0	2	0	3	0	4267	31	1409
450503	전라북도	익산시	황등면	6403	5042	4268	597	64	1	22	2	0	3	0	4	5	12	4978	64	1361
450504	전라북도	익산시	함라면	1966	1544	1287	199	28	0	12	0	0	0	1	2	1	2	1532	12	422
450505	전라북도	익산시	웅포면	1321	1090	929	140	9	0	3	0	0	0	1	1	0	2	1085	5	231
450506	전라북도	익산시	성당면	1643	1235	1037	161	19	0	5	0	0	2	0	2	0	1	1227	8	408
450507	전라북도	익산시	용안면	2175	1685	1364	261	19	3	5	0	1	1	1	2	1	4	1662	23	490
450508	전라북도	익산시	낭산면	2530	1927	1561	292	35	1	13	0	0	0	0	4	0	4	1910	17	603
450509	전라북도	익산시	망성면	2472	1815	1356	400	26	2	17	0	0	1	0	1	1	2	1806	9	657
450510	전라북도	익산시	여산면	2849	2197	1735	377	35	0	19	2	1	0	3	1	0	2	2175	22	652
450511	전라북도	익산시	금마면	4769	3754	2971	648	71	2	22	0	0	3	0	0	2	4	3723	31	1015
450512	전라북도	익산시	왕궁면	3403	2584	2154	359	24	2	12	0	0	0	4	1	0	3	2559	25	819
450513	전라북도	익산시	춘포면	3446	2597	2220	283	30	1	20	0	2	0	1	1	2	3	2563	34	849
450514	전라북도	익산시	삼기면	2489	1955	1655	227	26	0	10	1	1	2	1	0	1	5	1929	26	534
450515	전라북도	익산시	용동면	1329	1036	825	181	12	0	5	0	0	0	0	3	1	2	1029	7	293
450516	전라북도	익산시	중앙동	3945	3217	2602	511	46	2	24	1	0	0	4	1	0	2	3193	24	728
450517	전라북도	익산시	평화동	3830	3073	2609	379	30	0	26	0	0	0	0	6	0	3	3053	20	757
450518	전라북도	익산시	인화동	5902	4507	3745	621	70	1	29	0	0	2	3	4	1	0	4476	31	1395
450519	전라북도	익산시	동산동	16569	12391	10583	1446	176	2	67	3	2	0	5	13	3	12	12312	79	4178
450520	전라북도	익산시	마동	8771	6822	5644	954	97	5	48	4	1	0	2	6	3	8	6772	50	1949
450521	전라북도	익산시	남중동	10139	7800	6369	1216	105	3	53	1	1	1	2	4	2	4	7761	39	2339
450522	전라북도	익산시	모현동	26928	21059	17552	2934	310	3	127	3	1	2	0	7	2	7	20948	111	5869
450523	전라북도	익산시	송학동	8098	6734	5776	783	91	0	52	3	0	0	2	2	0	4	6713	21	1364
450524	전라북도	익산시	신동	11792	8600	6493	1721	182	2	84	2	0	1	1	9	3	6	8504	96	3192
450525	전라북도	익산시	영등1동	16493	12742	10370	1930	235	2	81	1	0	2	1	17	4	10	12653	89	3751
450526	전라북도	익산시	영등2동	12048	9916	8207	1370	197	6	60	2	0	1	1	11	1	6	9862	54	2132
450527	전라북도	익산시	어양동	18626	14438	11822	2127	278	8	96	3	0	3	2	15	2	5	14361	77	4188
450528	전라북도	익산시	팔봉동	5928	4626	3790	602	75	2	37	6	5	1	4	4	2	8	4536	90	1302
450529	전라북도	익산시	삼성동	23038	17430	14570	2293	292	11	95	2	1	4	2	11	1	13	17295	135	5608
450701	전라북도	정읍시	신태인읍	4706	3679	3153	399	51	2	16	2	1	2	0	2	5	10	3643	36	1027
450702	전라북도	정읍시	북면	3925	3141	2748	303	32	2	13	2	0	0	1	2	2	4	3109	32	784
450703	전라북도	정읍시	입암면	2473	1934	1668	197	27	1	7	0	0	2	2	1	2	8	1915	19	539
450704	전라북도	정읍시	소성면	1730	1364	1179	135	20	0	5	1	0	0	2	4	1	7	1354	10	366
450705	전라북도	정읍시	고부면	2289	1760	1512	195	16	1	4	1	0	0	0	6	2	5	1742	18	529
450706	전라북도	정읍시	영원면	1452	1203	1014	145	16	0	6	3	0	0	0	8	0	4	1196	7	249
450707	전라북도	정읍시	덕천면	1587	1300	1144	125	14	0	3	0	1	0	0	4	0	2	1293	7	287
450708	전라북도	정읍시	이평면	1714	1361	1165	143	22	0	5	0	0	0	1	0	2	5	1343	18	353
450709	전라북도	정읍시	정우면	1913	1442	1192	199	21	2	6	0	0	0	1	3	2	5	1431	11	471
450710	전라북도	정읍시	태인면	2927	2301	1995	242	22	0	11	0	0	1	0	1	1	3	2276	25	626
450711	전라북도	정읍시	감곡면	2163	1559	1284	204	19	4	11	0	0	1	1	3	2	6	1535	24	604
450712	전라북도	정읍시	옹동면	1307	1017	869	107	11	1	5	0	1	1	0	2	0	8	1005	12	290
450713	전라북도	정읍시	칠보면	1955	1587	1391	154	21	1	5	2	0	0	0	1	1	3	1579	8	368
450714	전라북도	정읍시	산내면	1015	814	699	96	6	0	1	0	0	0	0	0	1	6	809	5	201
450715	전라북도	정읍시	산외면	1731	1373	1165	158	11	0	13	0	0	0	0	0	3	14	1364	9	358
450716	전라북도	정읍시	수성동	13425	10174	8694	1148	141	4	87	4	1	2	4	10	3	4	10102	72	3251
450717	전라북도	정읍시	장명동	2644	2059	1761	237	26	2	12	0	0	1	1	0	0	1	2041	18	585
450718	전라북도	정읍시	내장상동	14853	11810	10126	1338	173	4	56	3	1	2	3	7	6	9	11728	82	3043
450719	전라북도	정읍시	시기동	3142	2614	2193	341	37	1	11	2	1	0	1	1	2	3	2593	21	528
450720	전라북도	정읍시	초산동	6747	5325	4554	618	81	4	28	0	1	1	1	2	0	4	5294	31	1422
450721	전라북도	정읍시	연지동	5565	4571	3872	579	56	0	29	0	0	0	0	0	2	3	4541	30	994
450722	전라북도	정읍시	농소동	2960	2215	1898	248	34	0	8	1	1	1	1	3	0	2	2197	18	745
450723	전라북도	정읍시	상교동	3108	2304	1982	244	19	1	16	2	1	0	0	3	0	12	2280	24	804
450801	전라북도	남원시	운봉읍	3189	2569	2205	276	33	0	12	2	0	2	2	1	1	10	2544	25	620
450802	전라북도	남원시	주천면	2102	1692	1432	215	17	3	6	1	0	0	0	1	3	5	1683	9	410
450803	전라북도	남원시	수지면	913	728	615	90	7	1	3	0	0	0	0	0	1	2	719	9	185
450804	전라북도	남원시	송동면	1625	1291	1120	129	14	0	9	2	0	0	2	0	1	3	1280	11	334
450805	전라북도	남원시	주생면	1521	1252	1040	161	23	2	4	0	1	1	0	3	1	6	1242	10	269
450806	전라북도	남원시	금지면	1963	1623	1389	179	19	3	7	0	0	0	0	1	1	10	1609	14	340
450807	전라북도	남원시	대강면	1341	1051	880	125	11	5	8	2	1	1	0	0	1	6	1040	11	290
450808	전라북도	남원시	대산면	1404	1111	906	123	22	5	7	1	1	1	2	5	2	5	1080	31	293
450809	전라북도	남원시	사매면	1270	984	837	104	13	0	8	0	0	0	0	1	3	6	972	12	286
450810	전라북도	남원시	덕과면	715	589	492	74	7	2	3	1	0	0	1	0	0	6	586	3	126
450811	전라북도	남원시	보절면	1223	986	828	117	9	0	7	1	1	0	1	2	1	5	972	14	237
450812	전라북도	남원시	산동면	1436	1164	997	115	11	0	11	5	0	0	0	2	1	11	1153	11	272
450813	전라북도	남원시	이백면	1838	1494	1293	148	22	0	12	0	0	1	2	0	1	2	1481	13	344
450814	전라북도	남원시	인월면	2338	1923	1611	257	22	2	12	0	0	0	0	2	4	5	1915	8	415
450815	전라북도	남원시	아영면	1554	1265	1072	143	19	1	12	0	0	0	1	0	2	8	1258	7	289
450816	전라북도	남원시	산내면	1618	1349	1122	160	35	1	5	7	0	0	0	6	1	4	1341	8	269
450817	전라북도	남원시	동충동	3039	2487	2089	327	35	1	13	2	1	0	0	2	0	2	2472	15	552
450818	전라북도	남원시	죽항동	2942	2312	1936	323	26	0	14	1	0	0	1	1	1	1	2304	8	630
450819	전라북도	남원시	노암동	4553	3635	3117	425	33	2	15	2	0	1	0	1	0	12	3608	27	918
450820	전라북도	남원시	금동	5421	4365	3788	486	38	1	25	1	1	0	0	1	2	2	4345	20	1056
450821	전라북도	남원시	왕정동	3505	2777	2357	345	23	0	17	2	0	0	2	1	1	4	2752	25	728
450822	전라북도	남원시	향교동	6070	4728	3970	603	62	0	43	2	2	1	2	7	3	2	4697	31	1342
450823	전라북도	남원시	도통동	11412	9021	7794	999	120	2	43	2	1	0	1	6	2	2	8972	49	2391
450901	전라북도	김제시	만경읍	2307	1872	1563	261	23	0	7	1	0	1	0	0	3	3	1862	10	435
450902	전라북도	김제시	죽산면	2001	1539	1315	176	13	2	6	0	0	0	0	0	1	6	1519	20	462
450903	전라북도	김제시	백산면	2106	1681	1425	201	15	2	12	0	0	0	0	1	1	7	1664	17	425
450904	전라북도	김제시	용지면	2730	2088	1790	234	21	0	14	1	0	0	1	2	2	7	2072	16	642
450905	전라북도	김제시	백구면	2980	2305	1970	276	20	0	15	1	0	1	1	1	2	5	2292	13	675
450906	전라북도	김제시	부량면	1075	859	742	91	12	0	3	1	0	0	0	0	0	0	849	10	216
450907	전라북도	김제시	공덕면	2050	1641	1410	183	17	2	11	0	1	2	0	1	1	3	1631	10	409
450908	전라북도	김제시	청하면	1429	1148	987	125	14	0	12	1	0	0	0	1	0	1	1141	7	281
450909	전라북도	김제시	성덕면	1372	1038	870	142	13	1	3	0	0	0	0	0	0	1	1030	8	334
450910	전라북도	김제시	진봉면	1947	1454	1259	140	14	0	15	0	0	0	1	2	0	3	1434	20	493
450911	전라북도	김제시	금구면	3877	3005	2591	321	43	1	12	0	0	1	1	2	3	10	2985	20	872
450912	전라북도	김제시	봉남면	1828	1414	1199	157	16	1	9	2	1	0	1	3	0	11	1400	14	414
450913	전라북도	김제시	황산면	1700	1358	1180	133	13	1	5	0	0	3	2	1	2	1	1341	17	342
450914	전라북도	김제시	금산면	3738	2933	2504	342	37	2	20	0	1	0	0	0	1	5	2912	21	805
450915	전라북도	김제시	광활면	1116	899	790	81	8	0	5	0	0	0	0	0	0	4	888	11	217
450916	전라북도	김제시	요촌동	8713	6822	5745	889	84	1	41	2	0	0	2	4	1	7	6776	46	1891
450917	전라북도	김제시	신풍동	9330	7155	6074	851	103	6	64	0	0	0	0	2	2	7	7109	46	2175
450918	전라북도	김제시	검산동	8930	6977	5933	810	107	5	51	1	0	1	1	6	3	6	6924	53	1953
450919	전라북도	김제시	교월동	5423	4301	3682	495	45	1	27	0	1	3	1	2	0	5	4262	39	1122
451001	전라북도	완주군	삼례읍	11285	8666	7367	1027	127	2	54	4	1	4	1	4	1	8	8600	66	2619
451002	전라북도	완주군	봉동읍	18038	14010	11769	1754	254	8	114	9	2	0	2	7	3	8	13930	80	4028
451003	전라북도	완주군	용진읍	5400	4177	3523	544	60	1	20	1	0	1	3	5	0	6	4164	13	1223
451004	전라북도	완주군	상관면	3214	2495	2099	312	42	2	15	1	0	0	1	4	1	3	2480	15	719
451005	전라북도	완주군	이서면	8762	6835	5648	942	140	3	37	0	0	0	3	8	1	7	6789	46	1927
451006	전라북도	완주군	소양면	4748	3714	3199	409	40	2	22	1	1	1	2	2	2	8	3689	25	1034
451007	전라북도	완주군	구이면	4449	3547	2978	469	44	0	16	1	0	0	0	2	1	10	3521	26	902
451008	전라북도	완주군	고산면	3906	3174	2749	312	49	2	13	2	0	0	3	3	1	7	3141	33	732
451009	전라북도	완주군	비봉면	1612	1323	1129	147	20	0	5	0	1	0	0	2	0	3	1307	16	289
451010	전라북도	완주군	운주면	1522	1189	875	262	23	1	8	1	1	1	1	2	0	2	1177	12	333
451011	전라북도	완주군	화산면	1972	1503	1252	200	19	1	11	2	0	0	0	1	2	8	1496	7	469
451012	전라북도	완주군	동상면	673	496	412	66	10	0	0	0	0	0	1	0	2	2	493	3	177
451013	전라북도	완주군	경천면	902	780	629	124	14	0	5	0	0	1	0	0	1	2	776	4	122
451101	전라북도	진안군	진안읍	7577	5955	4959	809	74	3	37	4	0	0	1	1	3	13	5904	51	1622
451102	전라북도	진안군	용담면	700	579	442	120	9	0	3	0	0	1	0	0	3	0	578	1	121
451103	전라북도	진안군	안천면	852	724	560	136	10	1	9	1	0	0	0	0	0	3	720	4	128
451104	전라북도	진안군	동향면	1053	904	790	81	11	1	4	1	0	0	0	1	0	2	891	13	149
451105	전라북도	진안군	상전면	613	509	436	58	5	0	2	0	0	0	0	0	3	1	505	4	104
451106	전라북도	진안군	백운면	1438	1152	988	125	10	1	6	0	1	1	0	1	2	3	1138	14	286
451107	전라북도	진안군	성수면	1244	999	853	104	11	2	3	1	0	0	1	3	4	9	991	8	245
451108	전라북도	진안군	마령면	1406	1134	976	126	15	0	2	0	0	1	0	1	1	3	1125	9	272
451109	전라북도	진안군	부귀면	1982	1587	1379	172	15	0	5	0	0	2	3	1	0	4	1581	6	395
451110	전라북도	진안군	정천면	798	655	559	74	10	0	1	0	0	0	0	0	1	4	649	6	143
451111	전라북도	진안군	주천면	1226	1002	750	203	21	1	5	2	0	1	2	1	1	5	992	10	224
451201	전라북도	무주군	무주읍	7392	5959	4599	1122	127	4	45	2	0	0	1	3	3	8	5914	45	1433
451202	전라북도	무주군	무풍면	1833	1480	1056	365	28	0	9	1	0	0	0	1	3	7	1470	10	353
451203	전라북도	무주군	설천면	3030	2431	1841	487	40	3	18	1	0	2	2	1	1	6	2402	29	599
451204	전라북도	무주군	적상면	2145	1684	1280	344	21	1	12	1	2	0	0	1	0	6	1668	16	461
451205	전라북도	무주군	안성면	3414	2704	2244	366	39	4	20	2	0	0	1	4	1	7	2688	16	710
451206	전라북도	무주군	부남면	1142	912	694	177	11	0	4	0	1	1	0	0	3	7	898	14	230
451301	전라북도	장수군	장수읍	5506	4542	3804	588	56	2	27	4	0	1	1	4	4	11	4502	40	964
451302	전라북도	장수군	산서면	1596	1344	1174	128	10	2	3	0	0	0	1	0	0	10	1328	16	252
451303	전라북도	장수군	번암면	1849	1484	1244	180	20	1	6	0	1	1	0	1	1	14	1469	15	365
451304	전라북도	장수군	장계면	3447	2796	2347	347	37	3	26	3	0	1	0	2	0	7	2773	23	651
451305	전라북도	장수군	천천면	1662	1303	1083	171	18	1	8	0	1	0	0	3	1	6	1292	11	359
451306	전라북도	장수군	계남면	1632	1332	1140	135	21	1	8	1	0	0	0	1	2	8	1317	15	300
451307	전라북도	장수군	계북면	1240	1019	860	122	16	1	9	0	0	0	0	1	0	4	1013	6	221
451401	전라북도	임실군	임실읍	5458	4382	3614	605	73	2	29	1	1	2	1	1	3	10	4342	40	1076
451402	전라북도	임실군	청웅면	1066	864	741	93	11	0	6	0	0	0	0	0	1	4	856	8	202
451403	전라북도	임실군	운암면	1013	774	654	95	4	1	5	0	0	1	0	0	0	8	768	6	239
451404	전라북도	임실군	신평면	1002	781	648	96	10	2	5	1	0	0	0	0	1	7	770	11	221
451405	전라북도	임실군	성수면	1216	980	846	108	9	1	6	0	0	0	0	0	0	8	978	2	236
451406	전라북도	임실군	오수면	2978	2406	2096	229	25	3	13	0	0	2	0	1	4	11	2384	22	572
451407	전라북도	임실군	신덕면	901	698	609	64	3	0	3	1	0	1	0	0	1	8	690	8	203
451408	전라북도	임실군	삼계면	1077	822	708	80	13	0	5	0	0	0	1	0	2	4	813	9	255
451409	전라북도	임실군	관촌면	2771	2297	1993	238	15	4	13	2	0	0	0	2	3	11	2281	16	474
451410	전라북도	임실군	강진면	1284	1019	866	115	20	0	6	0	0	0	0	1	1	4	1013	6	265
451411	전라북도	임실군	덕치면	861	672	583	64	6	1	2	0	0	0	0	1	2	5	664	8	189
451412	전라북도	임실군	지사면	875	704	616	58	11	0	5	1	0	0	1	1	0	4	697	7	171
451501	전라북도	순창군	순창읍	7130	5729	4922	621	77	2	39	3	0	0	2	10	4	6	5686	43	1401
451502	전라북도	순창군	인계면	1203	971	844	97	10	3	2	0	0	2	0	1	1	5	965	6	232
451503	전라북도	순창군	동계면	1533	1243	1058	132	17	0	3	3	0	0	1	0	3	6	1223	20	290
451504	전라북도	순창군	적성면	1028	832	718	90	8	0	3	0	0	0	0	2	1	1	823	9	196
451505	전라북도	순창군	유등면	888	710	643	48	6	0	3	0	0	0	1	1	2	3	707	3	178
451506	전라북도	순창군	풍산면	1269	989	851	96	15	0	3	0	0	0	0	5	0	7	977	12	280
451507	전라북도	순창군	금과면	1375	1135	972	125	7	1	6	1	0	0	0	0	1	7	1120	15	240
451508	전라북도	순창군	팔덕면	1188	966	852	85	8	1	4	1	0	0	0	1	1	3	956	10	222
451509	전라북도	순창군	복흥면	1642	1373	1191	137	12	1	6	0	0	1	2	1	1	9	1361	12	269
451510	전라북도	순창군	쌍치면	1512	1243	1074	133	11	1	2	2	0	0	1	3	0	3	1230	13	269
451511	전라북도	순창군	구림면	1805	1458	1258	135	15	0	4	2	2	1	0	7	4	9	1437	21	347
451601	전라북도	고창군	고창읍	14757	11511	9807	1377	171	1	56	4	2	4	2	7	1	9	11441	70	3246
451602	전라북도	고창군	고수면	2340	1924	1663	180	27	3	21	3	0	0	0	5	1	6	1909	15	416
451603	전라북도	고창군	아산면	2344	1933	1652	214	24	0	8	1	1	2	2	4	2	9	1919	14	411
451604	전라북도	고창군	무장면	2258	1765	1531	169	22	0	13	1	0	1	1	1	3	10	1752	13	493
451605	전라북도	고창군	공음면	2058	1630	1434	133	16	1	5	2	0	0	2	2	1	9	1605	25	428
451606	전라북도	고창군	상하면	1956	1566	1400	110	15	0	6	2	0	2	0	2	3	12	1552	14	390
451607	전라북도	고창군	해리면	2330	1823	1559	201	20	0	4	1	0	0	0	1	6	14	1806	17	507
451608	전라북도	고창군	성송면	1510	1203	1051	120	13	0	3	0	0	1	0	1	0	3	1192	11	307
451609	전라북도	고창군	대산면	2733	2175	1932	155	27	0	14	0	1	0	0	0	2	15	2146	29	558
451610	전라북도	고창군	심원면	2084	1681	1463	165	20	1	8	2	2	0	0	0	1	6	1668	13	403
451611	전라북도	고창군	흥덕면	2668	2107	1795	241	26	0	10	0	0	0	1	1	0	11	2085	22	561
451612	전라북도	고창군	성내면	1557	1212	1016	155	10	1	1	0	1	0	0	7	0	7	1198	14	345
451613	전라북도	고창군	신림면	1795	1423	1281	103	12	1	3	0	0	0	0	2	3	4	1409	14	372
451614	전라북도	고창군	부안면	2218	1747	1506	168	21	1	9	2	0	1	0	2	3	13	1726	21	471
451701	전라북도	부안군	부안읍	14652	11252	9530	1382	153	3	72	2	2	3	7	11	4	15	11184	68	3400
451702	전라북도	부안군	주산면	1653	1285	1087	149	14	1	5	2	0	1	1	1	5	6	1272	13	368
451703	전라북도	부안군	동진면	2271	1757	1484	207	21	1	7	2	0	0	2	0	2	15	1741	16	514
451704	전라북도	부안군	행안면	2921	2509	2154	264	42	1	18	2	0	1	1	1	0	4	2488	21	412
451705	전라북도	부안군	계화면	2713	2131	1863	200	26	1	12	0	1	1	1	1	2	8	2116	15	582
451706	전라북도	부안군	보안면	1947	1523	1286	195	15	0	5	0	0	1	1	1	0	6	1510	13	424
451707	전라북도	부안군	변산면	3521	2753	2324	349	27	2	13	0	0	0	0	2	1	9	2727	26	768
451708	전라북도	부안군	진서면	1899	1523	1305	168	9	0	6	0	1	0	1	3	1	10	1504	19	376
451709	전라북도	부안군	백산면	2113	1667	1426	191	14	2	5	0	0	0	1	1	1	10	1651	16	446
451710	전라북도	부안군	상서면	1722	1339	1125	165	14	1	13	0	0	0	0	0	0	7	1325	14	383
451711	전라북도	부안군	하서면	2249	1768	1513	194	23	1	8	2	0	0	1	3	0	9	1754	14	481
451712	전라북도	부안군	줄포면	2211	1757	1505	193	17	0	9	3	0	0	1	0	2	6	1736	21	454
451713	전라북도	부안군	위도면	790	616	527	60	7	0	3	1	0	2	0	1	1	4	606	10	174
460101	전라남도	목포시	용당1동	8488	6365	5609	571	83	5	38	1	0	0	2	10	1	7	6327	38	2123
460102	전라남도	목포시	용당2동	4608	3585	3158	341	35	1	21	0	0	1	1	3	2	1	3564	21	1023
460103	전라남도	목포시	연동	3902	2834	2510	255	27	3	8	1	1	0	1	2	0	6	2814	20	1068
460104	전라남도	목포시	산정동	6990	5510	4799	539	89	2	30	1	1	0	0	11	1	4	5477	33	1480
460105	전라남도	목포시	연산동	6538	5015	4415	436	88	1	32	0	1	0	0	2	0	3	4978	37	1523
460106	전라남도	목포시	원산동	9480	7109	6306	605	98	3	46	4	0	0	2	5	0	2	7071	38	2371
460107	전라남도	목포시	대성동	4139	3292	2885	324	40	1	15	0	0	0	1	8	1	2	3277	15	847
460108	전라남도	목포시	목원동	6299	4592	3948	505	69	3	25	1	0	1	1	2	2	4	4561	31	1707
460109	전라남도	목포시	동명동	4346	3270	2930	269	26	0	21	1	1	1	1	2	0	6	3258	12	1076
460110	전라남도	목포시	삼학동	5448	4461	4009	355	43	0	24	0	0	1	0	5	0	0	4437	24	987
460111	전라남도	목포시	만호동	2481	1774	1603	133	11	0	11	0	0	0	0	3	1	2	1764	10	707
460112	전라남도	목포시	유달동	3826	2940	2609	252	27	1	10	3	1	1	2	0	3	8	2917	23	886
460113	전라남도	목포시	죽교동	2785	2093	1822	209	25	1	12	1	0	0	1	2	0	3	2076	17	692
460114	전라남도	목포시	북항동	7380	5648	4955	544	68	0	39	0	1	0	2	4	0	5	5618	30	1732
460115	전라남도	목포시	용해동	12340	9507	8490	761	130	8	55	1	1	0	0	5	0	3	9454	53	2833
460116	전라남도	목포시	이로동	7595	6063	5294	619	80	1	29	2	0	3	0	7	0	2	6037	26	1532
460117	전라남도	목포시	상동	13699	10291	9035	968	134	5	63	3	0	5	0	10	2	8	10233	58	3408
460118	전라남도	목포시	하당동	9628	7072	6144	702	88	5	62	3	1	0	2	10	0	3	7020	52	2556
460119	전라남도	목포시	신흥동	11633	8906	7639	1005	117	4	67	3	0	2	0	8	2	5	8852	54	2727
460120	전라남도	목포시	삼향동	4540	3689	3205	367	53	2	26	2	1	0	1	3	1	4	3665	24	851
460121	전라남도	목포시	옥암동	8979	7415	6493	728	112	3	37	1	2	1	0	3	1	2	7383	32	1564
460122	전라남도	목포시	부흥동	7728	6294	5532	590	78	3	31	2	0	0	0	11	2	0	6249	45	1434
460123	전라남도	목포시	부주동	14497	11337	9686	1319	191	5	63	4	0	0	2	10	1	4	11285	52	3160
460201	전라남도	여수시	돌산읍	9121	6374	5625	591	58	5	38	2	2	0	1	4	1	16	6343	31	2747
460202	전라남도	여수시	소라면	15488	12163	10591	1216	133	6	80	6	1	2	3	15	2	17	12072	91	3325
460203	전라남도	여수시	율촌면	5092	3899	3453	321	39	3	19	1	0	1	0	4	2	17	3860	39	1193
460204	전라남도	여수시	화양면	5858	4555	4004	400	57	4	17	3	0	4	3	6	1	19	4518	37	1303
460205	전라남도	여수시	남면	2054	1605	1402	135	21	1	6	1	1	3	2	0	2	15	1589	16	449
460206	전라남도	여수시	화정면	1708	1344	1201	82	10	0	3	0	1	0	1	2	1	16	1317	27	364
460207	전라남도	여수시	삼산면	1414	1076	900	140	10	0	6	0	0	1	0	2	1	5	1065	11	338
460208	전라남도	여수시	동문동	4106	3173	2749	347	32	2	22	0	1	0	2	2	0	2	3159	14	933
460209	전라남도	여수시	한려동	3069	2452	2130	260	15	1	25	0	0	0	1	1	2	1	2436	16	617
460210	전라남도	여수시	중앙동	4562	3773	3305	377	39	3	22	3	0	0	1	1	0	4	3755	18	789
460211	전라남도	여수시	충무동	3200	2274	2032	179	19	1	19	0	1	0	0	1	0	5	2257	17	926
460212	전라남도	여수시	광림동	5905	4668	4148	413	40	4	19	2	0	1	2	6	4	7	4646	22	1237
460213	전라남도	여수시	서강동	3799	3043	2673	301	22	6	14	0	0	2	0	4	1	4	3027	16	756
460214	전라남도	여수시	대교동	5426	4264	3817	356	40	2	20	1	1	0	1	2	2	6	4248	16	1162
460215	전라남도	여수시	국동	9553	7454	6602	686	59	2	51	1	1	0	3	3	1	4	7413	41	2099
460216	전라남도	여수시	월호동	6043	5003	4339	542	51	1	45	1	0	0	2	3	1	0	4985	18	1040
460217	전라남도	여수시	여서동	14437	11299	9745	1245	145	1	90	1	1	2	0	7	2	3	11242	57	3138
460218	전라남도	여수시	문수동	16039	12253	10667	1312	118	3	69	1	1	3	2	12	3	5	12196	57	3786
460219	전라남도	여수시	미평동	10225	8127	6944	926	105	0	73	2	0	2	1	10	3	9	8075	52	2098
460220	전라남도	여수시	둔덕동	8231	6709	5827	689	88	1	57	1	0	3	0	6	0	4	6676	33	1522
460221	전라남도	여수시	만덕동	7716	6161	5212	801	72	1	34	1	1	0	1	3	0	6	6132	29	1555
460222	전라남도	여수시	쌍봉동	25249	20264	17125	2603	237	8	125	2	3	3	1	20	3	8	20138	126	4985
460223	전라남도	여수시	시전동	25297	19923	16897	2537	227	7	123	6	3	3	1	13	4	10	19831	92	5374
460224	전라남도	여수시	여천동	17708	13686	11643	1611	186	2	99	3	1	1	4	26	1	15	13592	94	4022
460225	전라남도	여수시	주삼동	6066	4830	4257	430	59	0	42	1	0	1	0	6	0	6	4802	28	1236
460226	전라남도	여수시	삼일동	2163	1749	1550	151	14	1	12	1	0	0	1	2	2	3	1737	12	414
460227	전라남도	여수시	묘도동	940	753	698	34	5	2	3	0	0	0	0	2	0	4	748	5	187
460401	전라남도	순천시	승주읍	2559	2044	1796	181	21	1	7	2	1	1	1	6	1	6	2024	20	515
460402	전라남도	순천시	주암면	2727	2164	1878	199	19	3	9	0	1	0	1	7	3	11	2131	33	563
460403	전라남도	순천시	송광면	1268	982	857	91	17	0	1	0	0	1	1	0	1	3	972	10	286
460404	전라남도	순천시	외서면	741	592	527	46	8	0	0	0	1	2	0	0	0	3	587	5	149
460405	전라남도	순천시	낙안면	2822	2243	1973	199	29	5	7	2	0	0	0	0	3	8	2226	17	579
460406	전라남도	순천시	별량면	4855	3785	3315	341	48	2	24	3	1	1	1	5	3	5	3749	36	1070
460407	전라남도	순천시	상사면	2831	2345	2056	228	21	1	9	3	0	0	0	2	0	6	2326	19	486
460408	전라남도	순천시	해룡면	31432	24144	20438	3015	326	5	131	5	2	2	1	29	4	10	23968	176	7288
460409	전라남도	순천시	서면	9968	7940	6794	888	111	11	58	3	2	4	4	8	4	5	7892	48	2028
460410	전라남도	순천시	황전면	2690	2149	1845	209	16	0	8	0	0	2	1	37	0	4	2122	27	541
460411	전라남도	순천시	월등면	1399	1143	1021	84	13	2	2	0	0	0	1	1	1	2	1127	16	256
460412	전라남도	순천시	향동	3311	2716	2309	326	33	1	13	2	2	1	0	3	0	8	2698	18	595
460413	전라남도	순천시	매곡동	5649	4625	3804	644	99	4	28	4	0	5	0	4	0	0	4592	33	1024
460414	전라남도	순천시	삼산동	19751	16083	13500	2066	258	9	104	8	0	5	0	16	0	4	15970	113	3668
460415	전라남도	순천시	조곡동	5357	4360	3701	523	69	2	30	0	0	0	0	9	2	1	4337	23	997
460416	전라남도	순천시	덕연동	31719	25423	21878	2832	324	4	173	5	3	3	1	35	3	12	25273	150	6296
460417	전라남도	순천시	풍덕동	7928	6518	5731	661	56	1	26	3	1	0	1	3	0	4	6487	31	1410
460418	전라남도	순천시	남제동	7120	5444	4725	581	56	2	31	0	0	4	0	12	2	3	5416	28	1676
460419	전라남도	순천시	저전동	2876	2417	2077	269	30	2	15	0	0	1	1	5	2	2	2404	13	459
460420	전라남도	순천시	장천동	2679	2161	1828	268	38	1	8	0	0	1	1	1	0	0	2146	15	518
460421	전라남도	순천시	중앙동	3622	3043	2626	318	45	4	18	0	0	2	3	3	1	1	3021	22	579
460422	전라남도	순천시	도사동	12727	10149	8805	1070	135	0	52	4	0	2	1	14	2	6	10091	58	2578
460423	전라남도	순천시	왕조1동	28936	22473	18569	3219	314	7	147	2	3	3	4	23	6	11	22308	165	6463
460424	전라남도	순천시	왕조2동	18088	15435	13380	1614	237	2	70	7	0	2	2	37	2	10	15363	72	2653
460601	전라남도	나주시	남평읍	9043	7179	6351	653	67	0	35	1	0	1	1	5	2	12	7128	51	1864
460602	전라남도	나주시	세지면	2308	1806	1640	128	15	2	1	0	0	1	0	1	1	4	1793	13	502
460603	전라남도	나주시	왕곡면	2376	1944	1721	159	17	1	9	1	1	2	1	2	0	13	1927	17	432
460604	전라남도	나주시	반남면	1160	933	838	71	3	0	2	1	1	1	0	0	1	5	923	10	227
460605	전라남도	나주시	공산면	1875	1550	1395	110	9	0	7	0	0	0	0	8	2	5	1536	14	325
460606	전라남도	나주시	동강면	1995	1578	1437	101	7	0	6	1	1	0	1	3	2	7	1566	12	417
460607	전라남도	나주시	다시면	3071	2540	2241	225	20	2	20	2	1	1	0	2	1	3	2518	22	531
460608	전라남도	나주시	문평면	1457	1099	969	85	9	2	4	1	0	0	0	2	0	8	1080	19	358
460609	전라남도	나주시	노안면	3597	2813	2525	194	21	2	10	3	2	1	3	10	1	5	2777	36	784
460610	전라남도	나주시	금천면	3457	2710	2387	234	33	1	17	2	0	0	3	6	3	7	2693	17	747
460611	전라남도	나주시	산포면	3192	2675	2383	226	19	1	12	1	0	1	0	3	2	3	2651	24	517
460612	전라남도	나주시	다도면	1515	1108	957	101	10	4	2	0	0	1	3	5	1	9	1093	15	407
460613	전라남도	나주시	봉황면	3170	2493	2246	173	24	1	10	2	3	0	1	1	2	9	2472	21	677
460614	전라남도	나주시	송월동	5730	4402	3703	537	58	5	43	3	3	3	1	8	3	3	4370	32	1328
460615	전라남도	나주시	영강동	2323	1785	1570	160	19	1	13	1	0	0	1	5	1	0	1771	14	538
460616	전라남도	나주시	금남동	4058	3135	2749	315	23	0	21	0	0	1	0	7	2	0	3118	17	923
460617	전라남도	나주시	성북동	7285	5952	5092	691	65	2	38	1	1	0	0	13	2	5	5910	42	1333
460618	전라남도	나주시	영산동	2444	1833	1619	162	15	2	10	1	0	1	1	0	1	6	1818	15	611
460619	전라남도	나주시	이창동	3354	2693	2343	251	32	0	28	3	0	0	0	3	4	7	2671	22	661
460620	전라남도	나주시	빛가람동	23260	18519	14857	3039	352	1	115	3	2	4	3	30	3	3	18412	107	4741
460701	전라남도	광양시	광양읍	33400	25084	21576	2798	280	7	182	3	3	6	6	43	10	22	24936	148	8316
460702	전라남도	광양시	봉강면	2952	2605	2261	266	24	2	13	1	1	1	0	1	0	8	2578	27	347
460703	전라남도	광양시	옥룡면	3501	3038	2651	313	26	0	15	1	0	0	1	3	0	12	3022	16	463
460704	전라남도	광양시	옥곡면	3600	2784	2363	342	35	1	13	1	0	0	0	2	1	8	2766	18	816
460705	전라남도	광양시	진상면	2444	1947	1709	161	27	1	7	1	0	0	1	6	1	6	1920	27	497
460706	전라남도	광양시	진월면	2371	1882	1602	205	23	1	15	2	0	0	0	1	0	10	1859	23	489
460707	전라남도	광양시	다압면	1453	1138	918	170	20	2	10	0	0	0	1	2	0	1	1124	14	315
460708	전라남도	광양시	골약동	3825	3291	2657	550	47	0	17	0	0	0	2	3	1	2	3279	12	534
460709	전라남도	광양시	중마동	39811	30086	24258	4765	517	9	274	3	1	3	5	57	5	7	29904	182	9725
460710	전라남도	광양시	광영동	10063	7637	6156	1213	115	5	89	2	1	1	0	13	1	5	7601	36	2426
460711	전라남도	광양시	태인동	1812	1503	1307	147	20	1	13	0	0	0	0	4	0	3	1495	8	309
460712	전라남도	광양시	금호동	8796	7393	5043	2070	173	3	54	1	1	2	1	5	1	2	7356	37	1403
460801	전라남도	담양군	담양읍	10621	8226	7171	831	92	2	50	0	1	4	2	6	3	13	8175	51	2395
460802	전라남도	담양군	봉산면	2173	1735	1555	139	12	1	7	2	1	1	1	2	1	3	1725	10	438
460803	전라남도	담양군	고서면	2444	1980	1759	159	12	0	7	0	0	1	0	6	0	19	1963	17	464
460805	전라남도	담양군	창평면	2819	2293	2036	176	23	1	7	2	0	0	1	6	2	12	2266	27	526
460806	전라남도	담양군	대덕면	1358	1055	918	106	14	1	2	0	0	0	2	0	0	3	1046	9	303
460807	전라남도	담양군	무정면	2051	1580	1330	185	16	1	19	0	0	1	0	1	1	7	1561	19	471
460808	전라남도	담양군	금성면	2102	1671	1464	151	17	1	6	1	1	1	2	2	2	6	1654	17	431
460809	전라남도	담양군	용면	1592	1326	1179	113	8	0	4	0	0	0	0	6	2	2	1314	12	266
460810	전라남도	담양군	월산면	2077	1708	1498	153	13	2	8	0	1	0	3	1	5	6	1690	18	369
460811	전라남도	담양군	수북면	3869	3281	2915	254	58	6	13	4	0	0	1	3	2	9	3265	16	588
460812	전라남도	담양군	대전면	3159	2562	2306	187	18	2	11	2	0	1	1	4	2	4	2538	24	597
460813	전라남도	담양군	가사문학면	885	723	644	59	5	0	1	0	0	0	0	3	1	5	718	5	162
460901	전라남도	장성군	장성읍	9957	7921	7001	707	92	4	41	1	1	2	2	3	0	19	7873	48	2036
460902	전라남도	장성군	진원면	2472	2027	1783	192	24	0	10	2	0	0	0	1	0	3	2015	12	445
460903	전라남도	장성군	남면	2820	2194	1944	183	27	1	16	0	0	0	0	2	0	7	2180	14	626
460904	전라남도	장성군	동화면	1637	1350	1177	131	12	0	5	0	0	0	0	5	3	5	1338	12	287
460905	전라남도	장성군	삼서면	2222	1733	1483	194	20	0	9	1	0	0	0	1	4	6	1718	15	489
460906	전라남도	장성군	삼계면	4148	3255	2505	639	45	1	24	0	2	0	1	2	1	7	3227	28	893
460907	전라남도	장성군	황룡면	3174	2452	2167	216	21	2	15	0	1	1	0	3	1	7	2434	18	722
460908	전라남도	장성군	서삼면	1146	937	811	104	10	1	1	1	0	0	0	1	0	2	931	6	209
460909	전라남도	장성군	북일면	1140	932	828	79	10	2	6	0	0	0	0	0	0	2	927	5	208
460910	전라남도	장성군	북이면	2266	1808	1594	161	17	1	10	1	1	0	0	0	3	3	1791	17	458
460911	전라남도	장성군	북하면	1709	1313	1143	116	17	3	5	0	2	0	1	1	1	7	1296	17	396
461001	전라남도	곡성군	곡성읍	6175	4960	4207	565	72	5	31	1	1	2	1	8	1	17	4911	49	1215
461002	전라남도	곡성군	오곡면	1479	1224	1023	152	21	1	8	0	0	0	0	3	2	4	1214	10	255
461003	전라남도	곡성군	삼기면	1269	991	856	100	3	1	6	1	1	0	0	0	2	7	977	14	278
461004	전라남도	곡성군	석곡면	2103	1721	1505	150	20	2	10	1	1	1	0	0	1	11	1702	19	382
461005	전라남도	곡성군	목사동면	931	693	598	62	6	1	1	2	0	0	1	0	0	10	681	12	238
461006	전라남도	곡성군	죽곡면	1366	1088	925	136	9	2	3	0	0	1	0	0	1	3	1080	8	278
461007	전라남도	곡성군	고달면	947	767	678	68	6	1	4	1	0	0	0	0	1	3	762	5	180
461008	전라남도	곡성군	옥과면	3359	2695	2291	296	48	2	21	0	0	1	1	1	3	6	2670	25	664
461009	전라남도	곡성군	입면	1738	1386	1193	127	21	0	10	2	0	0	1	6	2	7	1369	17	352
461010	전라남도	곡성군	겸면	1250	982	825	104	17	1	7	2	0	0	2	6	3	4	971	11	268
461011	전라남도	곡성군	오산면	1017	775	656	94	6	1	3	0	1	0	0	0	2	7	770	5	242
461101	전라남도	구례군	구례읍	7890	6451	5552	697	88	4	48	1	0	0	1	12	1	4	6408	43	1439
461102	전라남도	구례군	문척면	1240	1037	874	130	11	1	4	1	0	0	0	6	0	2	1029	8	203
461103	전라남도	구례군	간전면	1199	984	840	110	9	1	4	0	0	0	0	2	1	9	976	8	215
461104	전라남도	구례군	토지면	1941	1598	1351	192	14	1	7	2	1	0	0	2	1	8	1579	19	343
461105	전라남도	구례군	마산면	2256	1836	1550	202	27	2	14	3	0	2	0	6	0	2	1808	28	420
461106	전라남도	구례군	광의면	1812	1455	1262	151	15	1	7	1	0	0	1	3	0	4	1445	10	357
461107	전라남도	구례군	용방면	1267	1071	920	115	10	0	5	1	0	2	0	5	0	2	1060	11	196
461108	전라남도	구례군	산동면	2367	1944	1647	252	13	0	9	0	0	1	0	3	2	8	1935	9	423
461201	전라남도	고흥군	고흥읍	9165	7352	6296	846	97	2	47	4	1	2	1	9	1	6	7312	40	1813
461202	전라남도	고흥군	도양읍	8757	6942	5977	795	57	4	29	0	1	3	0	3	6	8	6883	59	1815
461203	전라남도	고흥군	풍양면	2784	2281	2024	182	20	2	22	1	0	3	1	1	1	8	2265	16	503
461204	전라남도	고흥군	도덕면	2409	1927	1716	167	10	2	1	0	1	0	0	4	2	7	1910	17	482
461205	전라남도	고흥군	금산면	3635	2960	2613	257	28	0	17	1	1	0	2	2	1	14	2936	24	675
461206	전라남도	고흥군	도화면	3395	2714	2370	260	12	1	17	3	2	0	2	6	1	14	2688	26	681
461207	전라남도	고흥군	포두면	4085	3253	2849	300	32	2	14	3	1	1	0	1	4	13	3220	33	832
461208	전라남도	고흥군	봉래면	1565	1234	1025	160	20	1	9	0	1	0	0	2	1	4	1223	11	331
461209	전라남도	고흥군	동일면	1231	992	844	109	9	3	4	0	0	0	0	0	3	8	980	12	239
461210	전라남도	고흥군	점암면	2169	1773	1517	177	19	2	12	2	0	0	0	2	2	12	1745	28	396
461211	전라남도	고흥군	영남면	1040	848	717	88	11	0	4	1	1	0	0	2	0	12	836	12	192
461212	전라남도	고흥군	과역면	3024	2517	2187	247	24	2	9	3	1	0	0	1	0	8	2482	35	507
461213	전라남도	고흥군	남양면	1794	1434	1224	135	12	3	9	0	0	1	2	8	1	12	1407	27	360
461214	전라남도	고흥군	동강면	2685	2164	1878	213	23	2	11	3	0	1	0	5	2	6	2144	20	521
461215	전라남도	고흥군	대서면	1762	1422	1260	114	19	1	3	0	0	0	0	2	2	7	1408	14	340
461216	전라남도	고흥군	두원면	2450	1995	1746	205	12	2	6	1	0	1	0	0	2	7	1982	13	455
461301	전라남도	보성군	보성읍	6819	5500	4715	597	61	1	46	5	1	2	1	13	5	5	5452	48	1319
461302	전라남도	보성군	벌교읍	9123	7157	6237	704	64	3	39	1	0	3	0	4	4	23	7082	75	1966
461303	전라남도	보성군	노동면	881	705	594	75	10	3	4	0	0	0	0	6	0	5	697	8	176
461304	전라남도	보성군	미력면	1121	891	782	76	12	1	2	0	0	0	0	3	0	1	877	14	230
461305	전라남도	보성군	겸백면	893	736	645	60	9	2	3	0	0	1	3	1	1	4	729	7	157
461306	전라남도	보성군	율어면	906	716	625	69	7	1	6	1	0	0	0	0	1	1	711	5	190
461307	전라남도	보성군	복내면	1286	1052	915	99	14	3	6	1	1	2	0	2	0	4	1047	5	234
461308	전라남도	보성군	문덕면	693	564	492	54	4	0	3	0	0	0	1	6	0	0	560	4	129
461309	전라남도	보성군	조성면	3072	2455	2159	213	30	0	12	0	1	2	2	4	0	10	2433	22	617
461310	전라남도	보성군	득량면	3243	2516	2168	257	29	2	12	2	0	1	1	11	1	7	2491	25	727
461311	전라남도	보성군	회천면	2469	1924	1692	177	12	0	12	0	0	0	0	6	0	7	1906	18	545
461312	전라남도	보성군	웅치면	948	779	676	78	5	0	2	1	0	0	0	3	1	2	768	11	169
461401	전라남도	화순군	화순읍	28662	22461	19685	2134	239	6	133	5	2	2	0	67	6	14	22293	168	6201
461402	전라남도	화순군	한천면	995	788	689	73	7	0	4	0	0	1	0	1	0	7	782	6	207
461403	전라남도	화순군	춘양면	1480	1152	1016	101	8	1	8	0	1	1	0	4	2	1	1143	9	328
461404	전라남도	화순군	청풍면	769	621	543	50	5	1	2	0	0	2	0	2	4	4	613	8	148
461405	전라남도	화순군	이양면	1535	1210	1083	74	8	1	5	1	0	0	2	2	2	6	1184	26	325
461406	전라남도	화순군	능주면	2805	2310	2050	194	17	1	19	2	1	1	0	5	1	1	2292	18	495
461407	전라남도	화순군	도곡면	2354	1916	1711	151	17	0	8	2	1	0	0	12	1	7	1910	6	438
461408	전라남도	화순군	도암면	1104	894	788	84	5	0	5	1	0	1	0	0	1	4	889	5	210
461409	전라남도	화순군	이서면	698	562	485	50	5	0	2	1	0	0	0	1	1	8	553	9	136
461411	전라남도	화순군	동복면	1327	1090	944	96	6	0	9	1	1	2	0	11	1	6	1077	13	237
461413	전라남도	화순군	동면	2925	2318	2019	221	18	1	10	1	1	3	3	8	1	10	2296	22	607
461414	전라남도	화순군	백아면	1152	897	797	61	10	2	3	2	0	0	3	3	1	10	892	5	255
461415	전라남도	화순군	사평면	1781	1441	1287	105	11	1	6	2	0	0	0	3	2	10	1427	14	340
461501	전라남도	장흥군	장흥읍	10911	8691	7597	841	86	0	65	0	2	2	1	21	5	17	8637	54	2220
461502	전라남도	장흥군	관산읍	4002	3169	2890	211	16	1	4	2	2	0	0	9	2	8	3145	24	833
461503	전라남도	장흥군	대덕읍	2759	2245	1945	207	34	2	15	1	1	0	0	2	2	13	2222	23	514
461504	전라남도	장흥군	용산면	1829	1511	1340	118	16	1	10	0	0	0	0	10	0	7	1502	9	318
461505	전라남도	장흥군	안양면	2346	1941	1735	143	20	2	3	3	1	0	2	5	2	6	1922	19	405
461506	전라남도	장흥군	장동면	979	801	687	83	7	0	6	0	0	0	0	4	0	4	791	10	178
461507	전라남도	장흥군	장평면	1670	1380	1210	100	7	1	6	2	2	1	0	16	1	17	1363	17	290
461508	전라남도	장흥군	유치면	790	617	504	73	14	3	8	1	0	0	2	6	0	3	614	3	173
461509	전라남도	장흥군	부산면	1322	1099	958	102	12	1	2	1	0	3	1	6	1	3	1090	9	223
461510	전라남도	장흥군	회진면	2233	1838	1641	140	17	1	2	0	0	0	0	0	0	13	1814	24	395
461601	전라남도	강진군	강진읍	10325	8189	6972	971	87	3	39	2	1	2	3	11	6	16	8113	76	2136
461602	전라남도	강진군	군동면	3153	2490	2097	303	33	3	19	2	0	0	1	5	2	5	2470	20	663
461603	전라남도	강진군	칠량면	1876	1563	1338	159	18	1	7	1	0	1	0	4	2	9	1540	23	313
461604	전라남도	강진군	대구면	952	767	668	81	5	2	1	0	0	0	0	1	1	0	759	8	185
461605	전라남도	강진군	마량면	1486	1212	1072	107	9	1	6	0	0	1	0	3	0	4	1203	9	274
461606	전라남도	강진군	도암면	1890	1529	1264	200	18	3	8	1	2	1	0	5	2	4	1508	21	361
461607	전라남도	강진군	신전면	1449	1198	1025	134	15	0	2	1	1	0	1	1	3	3	1186	12	251
461608	전라남도	강진군	성전면	2290	1879	1603	201	27	3	12	2	0	2	0	4	0	3	1857	22	411
461609	전라남도	강진군	작천면	1494	1172	1013	125	7	1	5	1	0	0	1	2	0	3	1158	14	322
461610	전라남도	강진군	병영면	1390	1140	993	105	10	1	7	1	0	1	0	1	0	2	1121	19	250
461611	전라남도	강진군	옴천면	483	398	345	42	2	1	2	0	0	0	0	0	0	1	393	5	85
461701	전라남도	완도군	완도읍	13844	10697	9383	1012	123	4	60	0	1	4	1	25	2	11	10626	71	3147
461702	전라남도	완도군	금일읍	2705	2236	2069	123	11	0	6	0	0	1	1	2	0	9	2222	14	469
461703	전라남도	완도군	노화읍	3886	3123	2828	201	19	1	12	5	1	1	0	6	5	13	3092	31	763
461704	전라남도	완도군	군외면	2442	1964	1688	207	26	0	12	0	0	0	0	1	0	8	1942	22	478
461705	전라남도	완도군	신지면	2763	2298	2074	159	15	0	16	0	1	1	0	3	1	8	2278	20	465
461706	전라남도	완도군	고금면	3385	2845	2562	194	17	1	13	0	1	2	0	6	3	11	2810	35	540
461707	전라남도	완도군	약산면	1866	1549	1377	121	12	0	10	0	0	1	0	6	1	8	1536	13	317
461708	전라남도	완도군	청산면	1746	1420	1223	132	9	3	9	3	0	0	2	2	2	14	1399	21	326
461709	전라남도	완도군	소안면	1860	1529	1389	89	14	0	7	0	0	0	1	1	1	13	1515	14	331
461710	전라남도	완도군	금당면	744	630	570	41	4	0	3	0	0	0	0	0	0	3	621	9	114
461711	전라남도	완도군	보길면	1989	1668	1495	109	18	1	8	1	0	1	0	2	0	7	1642	26	321
461712	전라남도	완도군	생일면	567	453	410	28	6	0	3	1	0	0	0	1	0	3	452	1	114
461801	전라남도	해남군	해남읍	17152	13006	11408	1233	124	8	88	5	1	1	3	24	4	13	12912	94	4146
461802	전라남도	해남군	삼산면	2651	2199	1915	212	22	0	12	2	0	0	0	7	0	5	2175	24	452
461803	전라남도	해남군	화산면	2647	2117	1840	207	22	1	12	1	0	0	2	3	1	6	2095	22	530
461804	전라남도	해남군	현산면	2452	2016	1759	178	17	1	4	1	0	0	1	9	1	8	1979	37	436
461805	전라남도	해남군	송지면	4894	3890	3398	338	45	2	23	4	0	0	0	6	3	20	3839	51	1004
461806	전라남도	해남군	북평면	2354	1980	1742	173	15	0	10	0	0	0	1	0	6	9	1956	24	374
461807	전라남도	해남군	북일면	1708	1408	1260	93	18	3	6	0	0	1	0	1	0	6	1388	20	300
461808	전라남도	해남군	옥천면	2894	2443	2118	245	27	0	8	1	0	0	0	9	5	5	2418	25	451
461809	전라남도	해남군	계곡면	1727	1366	1204	115	15	0	4	1	1	0	0	1	0	2	1343	23	361
461810	전라남도	해남군	마산면	2005	1639	1438	148	13	2	7	1	0	0	0	5	2	5	1621	18	366
461811	전라남도	해남군	황산면	3909	3126	2780	255	30	3	12	1	0	2	2	5	0	12	3102	24	783
461812	전라남도	해남군	산이면	2735	2162	1923	166	20	2	16	0	0	2	2	1	1	5	2138	24	573
461813	전라남도	해남군	문내면	3239	2574	2297	209	15	1	9	2	0	0	1	4	0	13	2551	23	665
461814	전라남도	해남군	화원면	2834	2192	1910	213	17	0	12	3	1	1	0	4	1	8	2170	22	642
461901	전라남도	진도군	진도읍	7872	6229	5372	685	61	1	39	0	0	0	5	4	1	8	6176	53	1643
461902	전라남도	진도군	군내면	2691	2238	1925	217	38	3	10	4	0	0	1	10	1	11	2220	18	453
461903	전라남도	진도군	고군면	2828	2180	1929	199	11	2	10	1	0	1	2	3	0	5	2163	17	648
461904	전라남도	진도군	의신면	3006	2390	2078	222	15	1	15	1	0	3	0	5	2	20	2362	28	616
461905	전라남도	진도군	임회면	2859	2281	1985	214	26	6	14	1	0	3	1	5	0	7	2262	19	578
461906	전라남도	진도군	지산면	2542	2015	1767	183	14	1	14	1	0	1	2	0	3	6	1992	23	527
461907	전라남도	진도군	조도면	1935	1416	1236	124	10	3	5	5	1	0	3	3	0	10	1400	16	519
462001	전라남도	영암군	영암읍	5883	4644	4041	457	65	4	23	2	1	0	2	7	1	7	4610	34	1239
462002	전라남도	영암군	삼호읍	14684	10442	8902	1157	179	7	105	6	1	2	0	10	3	6	10378	64	4242
462003	전라남도	영암군	덕진면	1622	1322	1165	117	18	0	5	0	0	1	0	1	1	2	1310	12	300
462004	전라남도	영암군	금정면	1623	1298	1126	128	12	0	8	1	0	0	0	0	2	11	1288	10	325
462005	전라남도	영암군	신북면	2929	2386	2137	187	17	2	11	0	0	0	1	2	1	5	2363	23	543
462006	전라남도	영암군	시종면	2830	2221	1965	188	16	1	5	2	0	0	2	3	2	8	2192	29	609
462007	전라남도	영암군	도포면	1733	1368	1213	115	10	1	7	0	1	1	0	1	0	4	1353	15	365
462008	전라남도	영암군	군서면	2531	2078	1793	218	24	3	15	0	1	0	0	2	1	4	2061	17	453
462009	전라남도	영암군	서호면	1536	1231	1047	140	9	0	5	0	0	1	1	4	3	6	1216	15	305
462010	전라남도	영암군	학산면	2921	2509	2130	273	44	2	17	1	0	0	2	0	1	10	2480	29	412
462011	전라남도	영암군	미암면	1574	1267	1092	137	15	2	9	1	0	0	0	1	1	5	1263	4	307
462101	전라남도	무안군	무안읍	8836	7102	6257	647	72	0	52	1	0	3	0	9	3	8	7052	50	1734
462102	전라남도	무안군	일로읍	9285	7351	6436	732	80	6	35	3	1	2	0	5	1	15	7316	35	1934
462103	전라남도	무안군	삼향읍	24585	18960	16239	2174	317	4	103	4	1	0	3	16	2	7	18870	90	5625
462104	전라남도	무안군	몽탄면	2337	1848	1646	152	21	1	4	0	0	0	1	4	0	7	1836	12	489
462105	전라남도	무안군	청계면	4921	3815	3361	351	27	0	14	5	0	0	2	3	2	16	3781	34	1106
462106	전라남도	무안군	현경면	3585	2800	2483	231	28	3	17	2	1	0	0	3	1	8	2777	23	785
462107	전라남도	무안군	망운면	1622	1327	1170	126	7	1	5	0	0	0	0	1	1	1	1312	15	295
462108	전라남도	무안군	해제면	4142	3260	2859	287	28	1	19	3	3	0	4	2	4	20	3230	30	882
462109	전라남도	무안군	운남면	2270	1819	1586	172	21	1	10	0	0	1	0	5	2	8	1806	13	451
462201	전라남도	영광군	영광읍	15242	11478	9968	1146	152	7	65	4	0	6	2	13	6	18	11387	91	3764
462202	전라남도	영광군	백수읍	3611	2817	2478	240	21	3	15	2	0	1	1	3	3	15	2782	35	794
462203	전라남도	영광군	홍농읍	4639	3639	2806	647	77	0	29	1	0	3	1	19	1	12	3596	43	1000
462204	전라남도	영광군	대마면	1373	1084	917	97	13	2	6	0	0	0	1	17	2	10	1065	19	289
462205	전라남도	영광군	묘량면	1408	1157	1023	95	10	1	6	0	0	0	0	5	2	8	1150	7	251
462206	전라남도	영광군	불갑면	1154	959	856	72	10	0	5	1	1	1	0	1	0	4	951	8	195
462207	전라남도	영광군	군서면	2274	1847	1607	169	25	0	8	2	3	1	1	4	2	12	1834	13	427
462208	전라남도	영광군	군남면	2018	1582	1372	137	18	2	6	1	1	2	1	2	3	18	1563	19	436
462209	전라남도	영광군	염산면	3260	2560	2263	197	17	0	14	1	0	2	0	3	6	21	2524	36	700
462210	전라남도	영광군	법성면	4277	3318	2903	286	29	0	22	1	0	0	1	10	5	19	3276	42	959
462211	전라남도	영광군	낙월면	320	232	212	10	1	0	0	0	0	0	1	0	1	2	227	5	88
462301	전라남도	함평군	함평읍	6557	5223	4595	439	71	3	29	4	1	1	1	4	5	16	5169	54	1334
462302	전라남도	함평군	손불면	2596	2021	1802	150	20	2	10	2	0	2	0	4	1	13	2006	15	575
462303	전라남도	함평군	신광면	1373	1128	1006	79	8	1	2	1	0	1	0	3	3	13	1117	11	245
462304	전라남도	함평군	학교면	2801	2180	1944	160	24	1	7	0	0	2	1	5	1	12	2157	23	621
462305	전라남도	함평군	엄다면	1435	1140	1012	87	11	1	7	1	0	0	4	2	0	6	1131	9	295
462306	전라남도	함평군	대동면	2423	1887	1646	190	16	0	10	0	0	0	0	1	2	11	1876	11	536
462307	전라남도	함평군	나산면	2133	1667	1480	130	18	1	8	2	0	0	0	3	2	7	1651	16	466
462308	전라남도	함평군	해보면	2132	1685	1509	118	23	3	5	1	0	2	1	3	0	7	1672	13	447
462309	전라남도	함평군	월야면	2794	2207	2013	140	13	0	12	0	0	0	0	7	3	5	2193	14	587
462401	전라남도	신안군	지도읍	3464	2754	2454	228	14	0	8	1	0	2	4	1	1	11	2724	30	710
462402	전라남도	신안군	증도면	1370	1115	991	85	13	1	5	2	0	0	1	0	0	4	1102	13	255
462403	전라남도	신안군	임자면	2280	1758	1555	159	9	1	9	0	1	0	1	0	1	10	1746	12	522
462404	전라남도	신안군	자은면	1743	1380	1219	116	13	0	7	3	0	0	0	2	0	7	1367	13	363
462405	전라남도	신안군	비금면	2504	1978	1728	177	21	4	11	0	0	1	0	4	2	3	1951	27	526
462406	전라남도	신안군	도초면	1867	1478	1309	126	13	2	7	1	0	0	0	2	0	7	1467	11	389
462407	전라남도	신안군	흑산면	2146	1522	1336	126	13	1	13	1	0	0	3	5	1	9	1508	14	624
462408	전라남도	신안군	하의면	1158	904	791	77	11	2	7	0	0	0	0	1	1	6	896	8	254
462409	전라남도	신안군	신의면	1011	797	699	65	8	0	9	2	0	1	3	0	1	3	791	6	214
462410	전라남도	신안군	장산면	1076	877	761	82	12	3	3	2	1	1	2	0	2	4	873	4	199
462411	전라남도	신안군	안좌면	2170	1683	1435	191	8	4	4	0	0	0	1	0	2	11	1656	27	487
462412	전라남도	신안군	팔금면	790	659	571	64	4	0	6	2	1	0	0	1	1	3	653	6	131
462413	전라남도	신안군	암태면	1513	1231	1096	94	10	0	7	1	0	0	1	1	1	4	1215	16	282
462414	전라남도	신안군	압해읍	4732	3772	3374	310	27	2	15	1	0	1	1	3	3	10	3747	25	960
470101	경상북도	포항시북구	흥해읍	30218	22685	5336	16385	494	7	216	9	5	9	25	20	7	2	22515	170	7533
470102	경상북도	포항시북구	신광면	2790	2267	347	1851	26	2	12	1	1	0	4	3	4	0	2251	16	523
470103	경상북도	포항시북구	청하면	4526	3611	609	2849	57	8	24	4	2	0	4	2	6	2	3567	44	915
470104	경상북도	포항시북구	송라면	2267	1859	261	1530	20	2	9	3	1	3	0	3	7	1	1840	19	408
470105	경상북도	포항시북구	기계면	4670	3789	554	3115	37	2	32	3	0	1	8	6	3	1	3762	27	881
470106	경상북도	포항시북구	죽장면	2334	1896	216	1617	18	2	10	2	0	1	1	5	2	3	1877	19	438
470107	경상북도	포항시북구	기북면	1238	1044	160	843	18	2	3	1	0	2	2	0	4	0	1035	9	194
470108	경상북도	포항시북구	중앙동	13349	9845	2010	7461	196	2	58	2	0	3	14	8	4	2	9760	85	3504
470110	경상북도	포항시북구	양학동	13083	10259	2641	7216	242	3	78	1	3	2	8	13	3	1	10211	48	2824
470111	경상북도	포항시북구	죽도동	17037	12136	2249	9445	191	4	127	2	1	2	24	5	2	1	12053	83	4901
470113	경상북도	포항시북구	용흥동	17064	13197	2937	9836	215	1	81	4	2	2	13	6	5	5	13107	90	3867
470114	경상북도	포항시북구	우창동	24596	18885	4988	13076	473	7	165	5	3	8	18	11	5	5	18764	121	5711
470115	경상북도	포항시북구	두호동	19898	16278	3768	11924	331	3	123	0	3	6	9	3	3	2	16175	103	3620
470116	경상북도	포항시북구	장량동	49032	37056	10962	24640	850	11	276	6	2	9	27	19	10	8	36820	236	11976
470117	경상북도	포항시북구	환여동	8000	6542	1769	4499	146	1	64	1	1	5	10	2	2	2	6502	40	1458
470201	경상북도	포항시남구	구룡포읍	6697	4959	642	4155	50	7	25	0	2	2	6	5	8	7	4909	50	1738
470202	경상북도	포항시남구	연일읍	22206	16888	4429	11725	402	12	143	3	2	3	12	10	12	7	16760	128	5318
470203	경상북도	포항시남구	오천읍	42071	29354	8722	19025	738	8	493	5	2	6	15	34	19	6	29073	281	12717
470204	경상북도	포항시남구	대송면	3356	2701	491	2109	39	0	28	0	0	2	0	3	4	1	2677	24	655
470205	경상북도	포항시남구	동해면	8237	6269	1358	4570	116	4	104	3	3	4	5	7	3	5	6182	87	1968
470206	경상북도	포항시남구	장기면	3549	2683	325	2197	44	1	28	2	0	0	7	0	6	6	2616	67	866
470207	경상북도	포항시남구	호미곶면	1709	1325	187	1092	14	2	6	0	0	0	1	2	2	1	1307	18	384
470208	경상북도	포항시남구	상대동	20259	14549	2872	11134	250	8	129	1	1	4	13	15	3	4	14434	115	5710
470210	경상북도	포항시남구	해도동	15127	11148	2026	8736	145	3	122	2	2	3	11	11	1	4	11066	82	3979
470212	경상북도	포항시남구	송도동	10207	7608	1196	6164	101	2	68	2	1	4	9	5	2	4	7558	50	2599
470213	경상북도	포항시남구	청림동	4397	3337	791	2367	59	2	67	1	0	1	2	8	0	1	3299	38	1060
470214	경상북도	포항시남구	제철동	3091	2498	705	1672	67	1	26	0	0	0	0	2	3	0	2476	22	593
470215	경상북도	포항시남구	효곡동	21768	18092	5863	11496	455	5	111	3	2	7	8	11	1	1	17963	129	3676
470216	경상북도	포항시남구	대이동	18271	14461	4297	9542	372	1	94	4	1	3	22	9	5	3	14353	108	3810
470301	경상북도	울릉군	울릉읍	4522	3409	818	2457	63	0	35	0	3	2	1	2	1	2	3384	25	1113
470302	경상북도	울릉군	서면	1080	903	192	684	8	3	10	0	0	0	1	0	0	1	899	4	177
470303	경상북도	울릉군	북면	964	769	162	578	9	0	9	0	0	0	2	0	0	2	762	7	195
470401	경상북도	경주시	감포읍	4414	3186	505	2589	30	1	20	2	0	1	4	3	2	0	3157	29	1228
470402	경상북도	경주시	안강읍	19796	14964	3060	11295	263	7	152	5	8	3	23	13	13	6	14848	116	4832
470403	경상북도	경주시	건천읍	7990	6049	1092	4700	90	5	71	3	1	4	10	6	6	7	5995	54	1941
470404	경상북도	경주시	외동읍	17360	12486	3803	8090	243	7	183	6	2	4	20	19	9	4	12390	96	4874
470406	경상북도	경주시	양남면	4997	3903	943	2796	56	3	39	3	1	2	6	10	4	5	3868	35	1094
470407	경상북도	경주시	내남면	4124	3224	663	2448	42	1	26	1	0	0	2	4	7	4	3198	26	900
470408	경상북도	경주시	산내면	2644	2008	331	1599	23	2	15	2	0	1	4	2	1	3	1983	25	636
470409	경상북도	경주시	서면	2873	2312	402	1831	30	2	18	0	0	1	1	5	5	0	2295	17	561
470410	경상북도	경주시	현곡면	15206	12067	3669	7863	317	2	100	5	1	3	18	19	2	3	12002	65	3139
470411	경상북도	경주시	강동면	5016	3797	744	2907	66	1	33	4	0	3	4	7	1	2	3772	25	1219
470412	경상북도	경주시	천북면	5327	4306	972	3162	57	2	52	2	1	0	6	3	6	2	4265	41	1021
470413	경상북도	경주시	중부동	5565	4519	808	3574	58	0	28	2	2	1	6	7	3	0	4489	30	1046
470415	경상북도	경주시	황오동	6406	5119	959	4009	63	4	41	2	1	1	9	3	4	2	5098	21	1287
470416	경상북도	경주시	성건동	11836	8919	1783	6813	140	3	86	1	2	1	14	5	3	1	8852	67	2917
470418	경상북도	경주시	황남동	4192	3277	600	2545	48	0	31	4	0	4	8	3	2	4	3249	28	915
470419	경상북도	경주시	월성동	4702	3704	772	2793	51	1	44	0	0	1	8	7	3	2	3682	22	998
470420	경상북도	경주시	선도동	11296	8717	2388	5971	188	2	76	4	1	3	13	8	3	5	8662	55	2579
470421	경상북도	경주시	용강동	16412	12681	3818	8242	317	5	145	3	1	6	17	16	5	3	12578	103	3731
470422	경상북도	경주시	황성동	20968	16453	4939	10782	406	6	149	5	1	5	15	23	7	3	16341	112	4515
470423	경상북도	경주시	동천동	17992	13883	3182	10114	264	1	161	3	1	3	9	22	3	8	13771	112	4109
470424	경상북도	경주시	불국동	8711	6857	1628	4971	116	1	69	3	0	1	11	8	3	2	6813	44	1854
470425	경상북도	경주시	보덕동	2229	1956	440	1433	38	2	17	1	0	1	2	6	1	1	1942	14	273
470426	경상북도	경주시	문무대왕면	3457	2675	447	2113	33	3	27	2	1	0	5	6	8	3	2648	27	782
470501	경상북도	김천시	아포읍	6469	4959	863	3914	58	3	59	1	0	0	8	4	5	3	4918	41	1510
470502	경상북도	김천시	농소면	2867	2389	541	1741	46	3	39	1	0	0	0	1	2	6	2380	9	478
470503	경상북도	김천시	남면	2671	2081	352	1641	39	1	18	0	1	0	3	2	1	2	2060	21	590
470504	경상북도	김천시	개령면	2204	1811	264	1490	15	0	19	1	0	1	3	1	2	1	1797	14	393
470505	경상북도	김천시	감문면	2772	2222	268	1872	23	3	13	1	1	1	7	4	8	1	2202	20	550
470506	경상북도	김천시	어모면	3660	2871	450	2304	41	3	30	0	4	1	1	4	4	1	2843	28	789
470507	경상북도	김천시	봉산면	3121	2621	528	1999	41	2	17	0	0	0	6	3	1	2	2599	22	500
470508	경상북도	김천시	대항면	3007	2401	404	1888	30	4	27	1	1	2	1	2	4	2	2366	35	606
470509	경상북도	김천시	감천면	1865	1568	256	1260	19	1	10	1	0	0	1	1	6	4	1559	9	297
470510	경상북도	김천시	조마면	1809	1440	196	1202	10	2	10	1	0	1	1	0	2	1	1426	14	369
470511	경상북도	김천시	구성면	2290	1789	248	1468	26	1	15	1	0	1	1	2	3	3	1769	20	501
470512	경상북도	김천시	지례면	1476	1229	228	955	12	0	6	1	0	0	4	4	5	1	1216	13	247
470513	경상북도	김천시	부항면	1015	795	118	645	8	3	5	0	0	1	0	1	3	3	787	8	220
470514	경상북도	김천시	대덕면	1721	1332	206	1058	22	1	11	1	0	1	1	2	5	6	1314	18	389
470515	경상북도	김천시	증산면	873	718	115	553	15	3	13	0	0	0	2	1	3	1	706	12	155
470516	경상북도	김천시	자산동	6119	4775	791	3809	70	0	52	1	0	1	5	3	2	1	4735	40	1344
470518	경상북도	김천시	평화남산동	6616	4973	868	3919	75	0	53	0	2	3	14	5	2	0	4941	32	1643
470519	경상북도	김천시	양금동	3618	2979	469	2408	39	0	26	0	0	2	9	2	1	2	2958	21	639
470520	경상북도	김천시	대신동	18309	13634	3465	9503	317	12	163	3	2	1	14	7	6	7	13500	134	4675
470521	경상북도	김천시	대곡동	15698	11839	2706	8675	225	10	109	0	0	3	13	3	5	6	11755	84	3859
470522	경상북도	김천시	지좌동	8354	6118	1352	4473	130	1	81	0	1	0	7	8	4	2	6059	59	2236
470523	경상북도	김천시	율곡동	14413	11498	4659	6336	322	5	91	2	1	1	7	7	1	4	11436	62	2915
470601	경상북도	안동시	풍산읍	5838	4401	1116	3121	47	2	39	3	1	1	4	3	13	4	4354	47	1437
470602	경상북도	안동시	와룡면	3492	2663	700	1877	25	2	17	1	1	0	1	2	10	6	2642	21	829
470603	경상북도	안동시	북후면	2756	2071	439	1514	24	2	15	0	1	1	2	3	10	4	2015	56	685
470604	경상북도	안동시	서후면	2921	2178	497	1617	26	2	10	0	0	0	1	3	4	0	2160	18	743
470605	경상북도	안동시	풍천면	4884	3536	886	2488	62	2	40	1	1	0	8	5	8	3	3504	32	1348
470606	경상북도	안동시	일직면	2388	1906	335	1496	12	0	20	0	7	1	0	2	6	4	1883	23	482
470607	경상북도	안동시	남후면	1693	1350	287	1008	15	0	15	2	0	1	1	0	2	3	1334	16	343
470608	경상북도	안동시	남선면	1854	1505	379	1076	18	2	10	1	0	0	2	2	2	0	1492	13	349
470609	경상북도	안동시	임하면	2472	1814	399	1331	23	0	17	6	2	3	4	3	6	1	1795	19	658
470610	경상북도	안동시	길안면	2451	1909	409	1434	11	2	9	2	1	2	0	3	1	6	1880	29	542
470611	경상북도	안동시	임동면	1443	1124	221	863	9	1	9	1	2	0	0	0	3	4	1113	11	319
470612	경상북도	안동시	예안면	1562	1234	462	723	11	0	4	2	0	3	0	2	8	5	1220	14	328
470613	경상북도	안동시	도산면	1414	1132	281	795	16	0	5	1	1	0	1	0	11	4	1115	17	282
470614	경상북도	안동시	녹전면	1444	1127	242	836	9	1	15	0	0	0	2	1	1	2	1109	18	317
470615	경상북도	안동시	중구동	4921	3900	1048	2713	64	5	24	1	1	3	4	4	3	0	3870	30	1021
470616	경상북도	안동시	명륜동	4336	3455	958	2393	35	2	24	1	0	1	2	2	4	1	3423	32	881
470617	경상북도	안동시	용상동	16487	12505	3849	8144	237	5	128	3	0	0	15	11	12	6	12410	95	3982
470618	경상북도	안동시	서구동	7596	6076	1662	4226	74	2	56	3	0	0	5	5	1	2	6036	40	1520
470619	경상북도	안동시	태화동	9632	7050	1734	5065	98	2	76	0	3	4	12	5	5	0	7004	46	2582
470620	경상북도	안동시	평화동	5105	3969	1001	2833	66	1	33	0	0	1	3	1	1	0	3940	29	1136
470621	경상북도	안동시	안기동	5542	4446	1227	3043	76	1	48	1	0	2	6	4	3	5	4416	30	1096
470622	경상북도	안동시	옥동	15435	11560	3733	7393	207	7	105	0	1	3	13	5	9	7	11483	77	3875
470623	경상북도	안동시	송하동	12230	9460	3148	5991	159	2	83	0	2	0	12	1	3	1	9402	58	2770
470624	경상북도	안동시	강남동	7625	5999	2158	3643	101	0	41	0	0	2	6	3	2	1	5957	42	1626
470701	경상북도	구미시	선산읍	12326	9452	1494	7626	132	1	108	3	2	1	9	4	5	3	9388	64	2874
470702	경상북도	구미시	고아읍	24611	18346	4005	13597	340	4	188	5	6	6	21	12	7	7	18198	148	6265
470703	경상북도	구미시	무을면	1687	1349	192	1120	14	2	7	0	0	0	3	0	3	1	1342	7	338
470704	경상북도	구미시	옥성면	1499	1191	142	1004	11	1	5	0	0	1	2	1	2	7	1176	15	308
470705	경상북도	구미시	도개면	2039	1620	215	1358	16	1	13	0	1	0	1	2	2	0	1609	11	419
470706	경상북도	구미시	해평면	3709	2923	411	2417	27	0	30	0	0	1	3	4	3	4	2900	23	786
470708	경상북도	구미시	장천면	3215	2651	462	2096	40	1	16	0	0	1	5	4	1	1	2627	24	564
470709	경상북도	구미시	송정동	18217	13839	3324	9947	288	7	131	4	3	5	16	7	2	3	13737	102	4378
470712	경상북도	구미시	지산동	3488	3046	672	2244	59	0	38	1	2	0	2	0	0	1	3019	27	442
470713	경상북도	구미시	도량동	22690	17329	4127	12417	393	11	194	3	2	8	31	13	5	7	17211	118	5361
470714	경상북도	구미시	선주원남동	27856	20271	5620	13856	403	5	180	5	3	2	26	6	4	8	20118	153	7585
470715	경상북도	구미시	형곡1동	11601	9145	2204	6538	194	3	102	1	1	3	11	6	3	1	9067	78	2456
470716	경상북도	구미시	형곡2동	13398	10208	2271	7491	184	6	126	5	1	3	10	9	1	6	10113	95	3190
470717	경상북도	구미시	신평1동	4091	3350	742	2464	68	2	29	1	2	2	4	2	1	2	3319	31	741
470718	경상북도	구미시	신평2동	2511	1898	430	1380	39	0	20	1	1	0	7	2	1	1	1882	16	613
470719	경상북도	구미시	비산동	9885	7319	1999	4961	180	7	94	1	3	2	4	2	2	4	7259	60	2566
470722	경상북도	구미시	광평동	4467	3601	955	2480	74	0	44	3	2	1	5	4	0	2	3570	31	866
470723	경상북도	구미시	상모사곡동	23435	17049	4648	11601	380	11	201	4	3	5	30	15	5	7	16910	139	6386
470724	경상북도	구미시	임오동	12785	9021	2542	5988	221	4	147	1	0	0	14	5	7	2	8931	90	3764
470725	경상북도	구미시	인동동	34652	22184	6521	14428	537	13	360	3	3	2	40	9	10	7	21933	251	12468
470726	경상북도	구미시	진미동	15457	8744	2640	5568	196	6	201	0	0	3	10	10	3	1	8638	106	6713
470727	경상북도	구미시	양포동	31163	22420	7709	13557	586	6	284	3	1	4	17	15	7	5	22194	226	8743
470728	경상북도	구미시	산동읍	17555	13072	4673	7748	324	5	165	1	1	1	7	7	8	4	12944	128	4483
470729	경상북도	구미시	공단동	4294	3380	1062	2118	106	2	54	2	0	2	5	3	1	1	3356	24	914
470730	경상북도	구미시	원평동	8028	6045	1230	4594	99	4	59	1	0	0	9	5	1	2	6004	41	1983
470801	경상북도	영주시	풍기읍	8850	6792	1528	5029	102	2	43	0	4	1	2	14	13	2	6740	52	2058
470802	경상북도	영주시	이산면	1921	1524	312	1162	17	0	12	0	1	0	2	2	3	1	1512	12	397
470803	경상북도	영주시	평은면	1281	1021	161	832	9	0	4	0	0	0	2	0	2	3	1013	8	260
470804	경상북도	영주시	문수면	1780	1404	324	1025	16	1	13	0	0	0	1	3	2	4	1389	15	376
470805	경상북도	영주시	장수면	1998	1648	274	1316	20	0	12	1	0	0	3	1	5	0	1632	16	350
470806	경상북도	영주시	안정면	2665	2070	365	1642	16	1	15	0	0	0	3	2	4	1	2049	21	595
470807	경상북도	영주시	봉현면	2465	1947	330	1558	27	0	18	0	0	0	0	2	2	0	1937	10	518
470808	경상북도	영주시	순흥면	1872	1552	290	1190	28	1	24	1	1	0	2	0	0	3	1540	12	320
470809	경상북도	영주시	단산면	1623	1331	239	1029	24	3	11	1	1	0	1	2	2	4	1317	14	292
470810	경상북도	영주시	부석면	2571	2046	386	1583	32	2	11	0	1	2	4	6	5	2	2034	12	525
470811	경상북도	영주시	상망동	5810	4450	1140	3147	73	0	33	0	0	5	5	3	7	3	4416	34	1360
470812	경상북도	영주시	하망동	4807	3827	884	2829	48	2	29	1	4	1	4	3	2	2	3809	18	980
470813	경상북도	영주시	영주1동	3649	2815	571	2156	31	0	21	2	0	1	6	3	2	0	2793	22	834
470814	경상북도	영주시	영주2동	4801	3908	913	2878	53	0	26	1	1	0	11	2	4	1	3890	18	893
470815	경상북도	영주시	휴천1동	4682	3550	1031	2389	60	1	35	0	0	1	2	6	4	1	3530	20	1132
470816	경상북도	영주시	휴천2동	8284	6441	1588	4646	105	4	47	0	0	1	3	1	3	7	6405	36	1843
470817	경상북도	영주시	휴천3동	6186	4836	1267	3431	66	0	29	1	0	1	5	1	2	1	4804	32	1350
470818	경상북도	영주시	가흥1동	10725	8194	2847	5043	146	2	64	2	0	4	3	6	8	1	8126	68	2531
470819	경상북도	영주시	가흥2동	7079	5262	1536	3523	97	2	50	1	0	0	5	8	2	3	5227	35	1817
470901	경상북도	영천시	금호읍	8817	6636	1070	5315	80	1	86	2	3	0	11	5	6	5	6584	52	2181
470902	경상북도	영천시	청통면	3247	2510	340	2099	25	0	20	2	0	0	1	4	3	1	2495	15	737
470903	경상북도	영천시	신녕면	3199	2477	348	2040	26	0	31	0	2	1	2	3	3	1	2457	20	722
470904	경상북도	영천시	화산면	2623	1926	317	1502	24	2	19	3	2	1	3	4	7	7	1891	35	697
470905	경상북도	영천시	화북면	1818	1415	238	1128	15	1	6	0	0	1	4	6	2	2	1403	12	403
470906	경상북도	영천시	화남면	2728	2135	327	1750	18	0	14	0	0	0	1	4	2	1	2117	18	593
470907	경상북도	영천시	자양면	869	668	99	539	7	1	8	1	0	0	0	4	2	1	662	6	201
470908	경상북도	영천시	임고면	3636	2856	493	2269	26	1	27	0	1	0	5	3	1	2	2828	28	780
470909	경상북도	영천시	고경면	4614	3578	653	2769	43	5	44	1	3	1	11	6	3	0	3539	39	1036
470910	경상북도	영천시	북안면	3616	2754	510	2091	31	1	25	2	0	3	8	5	6	10	2692	62	862
470911	경상북도	영천시	대창면	2597	1981	303	1608	31	1	12	1	1	0	2	3	0	2	1964	17	616
470912	경상북도	영천시	동부동	20359	14701	3416	10594	275	5	198	1	2	3	26	10	11	13	14554	147	5658
470913	경상북도	영천시	중앙동	8314	6476	1516	4688	146	4	44	0	4	2	5	6	4	0	6419	57	1838
470914	경상북도	영천시	서부동	4242	3271	611	2496	57	0	47	2	1	2	8	7	2	7	3240	31	971
470915	경상북도	영천시	완산동	7757	6048	1315	4517	104	2	52	0	0	1	9	7	2	3	6012	36	1709
470916	경상북도	영천시	남부동	3528	2571	492	1969	40	1	30	1	1	2	8	4	2	3	2553	18	957
471001	경상북도	상주시	함창읍	5305	4206	703	3335	63	3	42	2	2	2	5	5	9	3	4174	32	1099
471003	경상북도	상주시	중동면	1130	964	92	838	7	0	10	1	0	0	1	2	4	2	957	7	166
471004	경상북도	상주시	낙동면	3273	2547	338	2131	20	3	10	1	1	1	6	3	6	1	2521	26	726
471005	경상북도	상주시	청리면	2311	1896	240	1604	21	0	14	0	0	0	1	1	2	1	1884	12	415
471006	경상북도	상주시	공성면	3375	2659	344	2225	26	1	23	1	1	2	4	0	4	1	2632	27	716
471007	경상북도	상주시	외남면	1431	1146	174	923	21	2	3	1	1	0	2	0	5	1	1133	13	285
471008	경상북도	상주시	내서면	1590	1306	233	1024	14	0	4	0	2	0	2	7	4	2	1292	14	284
471009	경상북도	상주시	모동면	2111	1730	411	1247	20	1	23	1	0	2	4	1	1	2	1713	17	381
471010	경상북도	상주시	모서면	2130	1746	346	1315	33	2	22	0	0	0	2	3	3	3	1729	17	384
471011	경상북도	상주시	화동면	1634	1325	258	1022	9	1	14	0	0	1	2	0	1	2	1310	15	309
471012	경상북도	상주시	화서면	2478	1976	297	1592	29	2	23	0	1	0	1	4	1	2	1952	24	502
471013	경상북도	상주시	화북면	1331	1084	250	766	18	1	27	1	0	1	7	0	2	1	1074	10	247
471014	경상북도	상주시	외서면	1846	1349	247	1039	21	0	10	1	0	1	6	3	6	3	1337	12	497
471015	경상북도	상주시	은척면	1314	1097	174	868	8	0	11	1	2	0	5	2	3	3	1077	20	217
471016	경상북도	상주시	공검면	2078	1711	240	1396	20	1	8	0	0	2	1	1	7	5	1681	30	367
471017	경상북도	상주시	이안면	1572	1296	210	1022	13	1	9	1	1	0	5	3	4	1	1270	26	276
471018	경상북도	상주시	화남면	591	458	78	355	8	1	4	0	0	0	2	0	3	3	454	4	133
471019	경상북도	상주시	남원동	9359	7411	1688	5465	125	2	60	2	0	0	3	11	6	3	7365	46	1948
471020	경상북도	상주시	북문동	7202	5568	1216	4113	109	2	51	4	1	3	11	7	4	1	5522	46	1634
471021	경상북도	상주시	계림동	6489	4886	1100	3606	82	4	34	1	0	2	5	8	7	4	4853	33	1603
471022	경상북도	상주시	동문동	6435	5026	1018	3833	80	3	44	1	1	0	1	5	2	4	4992	34	1409
471023	경상북도	상주시	동성동	3575	2913	599	2210	52	2	18	0	0	1	2	1	3	1	2889	24	662
471024	경상북도	상주시	신흥동	6087	4560	1047	3346	83	3	40	1	0	0	8	4	2	1	4535	25	1527
471025	경상북도	상주시	사벌국면	3201	2550	404	2024	30	5	13	3	1	5	7	2	6	0	2500	50	651
471101	경상북도	문경시	문경읍	5875	4527	814	3564	47	4	35	0	0	0	6	4	10	3	4487	40	1348
471102	경상북도	문경시	가은읍	3388	2670	532	2024	41	6	19	0	0	0	11	5	7	4	2649	21	718
471103	경상북도	문경시	영순면	1986	1587	218	1310	15	2	9	0	0	1	2	2	8	2	1569	18	399
471104	경상북도	문경시	산양면	2495	1909	268	1574	24	0	16	0	0	2	1	2	5	3	1895	14	586
471105	경상북도	문경시	호계면	1976	1502	241	1210	13	4	11	0	0	0	4	1	2	3	1489	13	474
471106	경상북도	문경시	산북면	2413	1939	334	1521	24	0	16	0	1	1	4	3	8	2	1914	25	474
471107	경상북도	문경시	동로면	1589	1253	223	977	9	2	10	2	0	1	3	1	2	4	1234	19	336
471108	경상북도	문경시	마성면	3028	2327	355	1876	27	5	12	0	0	1	4	4	9	3	2296	31	701
471109	경상북도	문경시	농암면	2210	1688	260	1307	32	2	23	4	0	7	29	1	8	0	1673	15	522
471110	경상북도	문경시	점촌1동	5312	4220	747	3344	50	0	24	3	1	0	7	2	3	3	4184	36	1092
471111	경상북도	문경시	점촌2동	5977	4549	796	3604	55	2	39	0	0	1	11	5	2	1	4516	33	1428
471112	경상북도	문경시	점촌3동	7062	5355	1078	4106	71	2	40	0	0	0	8	6	5	3	5319	36	1707
471113	경상북도	문경시	점촌4동	2651	1959	330	1544	33	3	20	0	0	0	7	2	1	1	1941	18	692
471114	경상북도	문경시	점촌5동	11047	8336	2024	5961	207	2	59	2	1	3	12	8	8	0	8287	49	2711
471201	경상북도	예천군	예천읍	12021	9443	1872	7216	143	5	77	2	6	3	18	6	11	4	9363	80	2578
471202	경상북도	예천군	용문면	1984	1608	267	1259	28	1	13	2	0	1	5	2	6	2	1586	22	376
471205	경상북도	예천군	감천면	2336	1921	320	1512	24	2	13	0	1	1	12	6	8	6	1905	16	415
471206	경상북도	예천군	보문면	1503	1238	198	998	11	0	6	0	0	1	2	1	2	1	1220	18	265
471207	경상북도	예천군	호명면	11876	9358	3438	5521	222	3	67	1	0	3	13	7	6	6	9287	71	2518
471208	경상북도	예천군	유천면	2182	1775	308	1365	29	2	20	0	2	1	6	3	11	2	1749	26	407
471209	경상북도	예천군	용궁면	2171	1795	230	1497	11	2	6	2	2	3	3	1	7	3	1767	28	376
471210	경상북도	예천군	개포면	1292	1050	139	881	4	0	4	0	0	0	1	2	5	0	1036	14	242
471211	경상북도	예천군	지보면	2343	1895	272	1541	23	1	14	3	0	1	2	4	11	2	1874	21	448
471212	경상북도	예천군	풍양면	2697	2171	288	1791	13	6	11	1	0	0	3	3	10	6	2132	39	526
471213	경상북도	예천군	효자면	951	814	130	644	15	0	8	1	1	0	1	1	2	1	804	10	137
471214	경상북도	예천군	은풍면	1255	1081	163	885	10	2	4	2	0	0	2	0	4	0	1072	9	174
471301	경상북도	경산시	하양읍	21672	16397	3646	12002	343	12	146	5	0	3	19	14	9	5	16204	193	5275
471302	경상북도	경산시	진량읍	27893	19867	4645	14204	367	20	298	4	4	6	47	19	14	16	19644	223	8026
471303	경상북도	경산시	와촌면	5294	4109	640	3280	57	5	37	1	3	3	4	2	3	5	4040	69	1185
471304	경상북도	경산시	자인면	5448	4287	667	3471	45	0	35	1	0	1	11	12	3	1	4247	40	1161
471305	경상북도	경산시	용성면	2831	2243	324	1806	26	2	17	1	0	1	6	10	3	3	2199	44	588
471306	경상북도	경산시	남산면	3431	2741	401	2216	37	0	27	0	1	0	5	4	2	2	2695	46	690
471308	경상북도	경산시	남천면	2843	2369	393	1885	40	2	18	0	0	0	10	3	2	1	2354	15	474
471309	경상북도	경산시	중앙동	7384	5870	1261	4320	126	1	79	1	1	1	16	5	2	1	5814	56	1514
471310	경상북도	경산시	동부동	28754	20679	4943	14846	393	17	237	9	3	1	29	27	3	9	20517	162	8075
471311	경상북도	경산시	서부1동	24612	17885	4105	12993	391	5	159	7	2	5	33	9	6	8	17723	162	6727
471312	경상북도	경산시	서부2동	25843	20398	4582	15106	401	4	122	5	1	7	23	8	6	6	20271	127	5445
471313	경상북도	경산시	남부동	16472	12505	2902	9114	244	3	120	2	4	4	18	10	6	0	12427	78	3967
471314	경상북도	경산시	북부동	12415	8024	1892	5738	188	4	93	3	3	3	16	9	0	3	7952	72	4391
471315	경상북도	경산시	중방동	9314	7448	1559	5601	139	4	65	1	1	4	12	3	0	3	7392	56	1866
471316	경상북도	경산시	압량읍	16633	11910	2961	8374	227	8	171	3	3	0	17	5	8	8	11785	125	4723
471401	경상북도	청도군	청도읍	10360	7825	1400	6095	133	7	85	1	1	1	16	12	9	6	7766	59	2535
471402	경상북도	청도군	화양읍	5840	4400	904	3308	78	4	46	2	0	3	1	5	9	5	4365	35	1440
471403	경상북도	청도군	각남면	1841	1473	218	1182	20	3	10	1	0	4	5	3	5	2	1453	20	368
471404	경상북도	청도군	풍각면	3414	2689	415	2167	32	1	26	2	0	1	7	2	10	3	2666	23	725
471405	경상북도	청도군	각북면	1724	1368	184	1149	11	0	10	0	0	0	2	1	2	0	1359	9	356
471406	경상북도	청도군	이서면	3542	2794	467	2229	41	0	12	1	1	2	4	3	1	7	2768	26	748
471407	경상북도	청도군	운문면	1639	1279	229	1005	18	0	9	0	1	0	2	3	4	0	1271	8	360
471408	경상북도	청도군	금천면	2702	2137	328	1729	25	1	23	0	0	1	5	5	5	0	2122	15	565
471409	경상북도	청도군	매전면	2978	2332	374	1871	31	0	9	3	2	1	1	5	5	1	2303	29	646
471501	경상북도	고령군	대가야읍	7949	6070	1100	4724	99	4	72	0	1	1	8	6	9	3	6027	43	1879
471502	경상북도	고령군	덕곡면	1186	955	138	766	10	3	9	0	0	1	1	9	4	2	943	12	231
471503	경상북도	고령군	운수면	1551	1251	185	1016	8	2	7	0	1	2	4	2	6	2	1235	16	300
471504	경상북도	고령군	성산면	2113	1648	223	1357	19	1	9	0	2	0	10	4	3	1	1629	19	465
471505	경상북도	고령군	다산면	6550	5046	1012	3835	77	2	53	2	0	2	14	11	2	1	5011	35	1504
471506	경상북도	고령군	개진면	1553	1195	136	1022	11	0	8	1	0	1	4	2	2	1	1188	7	358
471507	경상북도	고령군	우곡면	1270	1010	123	834	12	1	8	1	0	2	2	4	6	1	994	16	260
471508	경상북도	고령군	쌍림면	2660	2068	288	1712	14	0	21	1	1	0	2	2	6	1	2048	20	592
471601	경상북도	성주군	성주읍	10673	8074	1760	6001	140	3	76	4	0	2	6	11	2	4	8009	65	2599
471602	경상북도	성주군	선남면	4986	3988	544	3327	41	3	29	2	2	1	11	1	4	1	3966	22	998
471603	경상북도	성주군	용암면	2964	2343	361	1895	29	1	20	1	1	0	3	3	6	1	2321	22	621
471604	경상북도	성주군	수륜면	2366	1891	282	1529	29	1	6	0	1	2	3	6	8	4	1871	20	475
471605	경상북도	성주군	가천면	1737	1418	216	1142	18	2	10	0	1	1	2	4	4	3	1403	15	319
471606	경상북도	성주군	금수면	907	749	131	590	4	2	6	1	0	1	1	2	1	1	740	9	158
471607	경상북도	성주군	대가면	2072	1693	330	1298	19	2	11	2	0	2	1	3	6	1	1675	18	379
471608	경상북도	성주군	벽진면	2598	2085	338	1664	35	1	17	0	0	2	1	2	2	2	2064	21	513
471609	경상북도	성주군	초전면	3901	3110	535	2440	36	3	43	2	1	2	10	6	6	2	3086	24	791
471610	경상북도	성주군	월항면	2668	2160	333	1755	23	1	16	2	1	1	8	3	6	1	2150	10	508
471701	경상북도	칠곡군	왜관읍	25563	18834	4311	13749	335	12	219	7	3	6	25	6	4	7	18684	150	6729
471702	경상북도	칠곡군	북삼읍	18267	13013	3275	9104	271	6	211	7	5	5	21	4	6	3	12918	95	5254
471703	경상북도	칠곡군	석적읍	21871	14291	4986	8493	330	1	296	2	3	4	16	11	7	5	14154	137	7580
471704	경상북도	칠곡군	지천면	3474	2699	358	2248	24	1	32	0	1	1	4	0	3	1	2673	26	775
471705	경상북도	칠곡군	동명면	4569	3511	498	2906	41	3	20	1	1	3	7	3	0	0	3483	28	1058
471706	경상북도	칠곡군	가산면	2729	2116	299	1735	21	2	20	1	0	0	6	4	6	0	2094	22	613
471707	경상북도	칠곡군	약목면	7979	5989	1056	4661	101	8	72	4	0	1	10	10	5	4	5932	57	1990
471708	경상북도	칠곡군	기산면	3058	2504	510	1877	47	3	26	2	1	1	4	6	5	3	2485	19	554
471801	경상북도	군위군	군위읍	6607	5306	757	4329	87	5	59	1	1	4	6	1	14	2	5266	40	1301
471802	경상북도	군위군	소보면	1834	1475	170	1243	8	1	12	0	0	3	5	4	5	5	1456	19	359
471803	경상북도	군위군	효령면	2969	2439	299	2060	24	3	15	1	0	0	0	5	4	2	2413	26	530
471804	경상북도	군위군	부계면	1696	1416	183	1187	10	4	7	0	1	2	4	0	5	4	1407	9	280
471805	경상북도	군위군	우보면	1600	1326	144	1137	10	0	10	1	0	1	1	4	2	1	1311	15	274
471806	경상북도	군위군	의흥면	1997	1653	192	1408	15	0	8	0	0	1	6	3	4	3	1640	13	344
471807	경상북도	군위군	산성면	977	823	93	692	11	0	8	0	0	0	2	2	5	4	817	6	154
471809	경상북도	군위군	삼국유사면	1010	812	122	657	9	1	6	0	0	0	1	3	5	0	804	8	198
471901	경상북도	의성군	의성읍	10147	7894	1466	6106	124	3	88	1	2	3	8	15	8	6	7830	64	2253
471902	경상북도	의성군	단촌면	1722	1418	225	1132	18	3	14	1	0	2	0	4	4	1	1404	14	304
471903	경상북도	의성군	점곡면	1410	1144	224	865	16	3	15	1	1	0	0	2	2	0	1129	15	266
471904	경상북도	의성군	옥산면	1506	1267	236	1000	9	1	6	0	0	0	1	1	0	2	1256	11	239
471905	경상북도	의성군	사곡면	1376	1141	156	947	9	2	11	0	0	1	2	3	2	1	1134	7	235
471906	경상북도	의성군	춘산면	1164	991	138	798	11	1	15	1	2	0	0	8	4	2	980	11	173
471907	경상북도	의성군	가음면	1347	1160	172	943	19	0	12	0	0	1	1	3	2	1	1154	6	187
471908	경상북도	의성군	금성면	3602	2913	409	2402	27	1	19	1	1	2	0	10	6	4	2882	31	689
471909	경상북도	의성군	봉양면	3321	2675	372	2217	37	2	21	2	0	1	1	1	2	2	2658	17	646
471910	경상북도	의성군	비안면	1991	1615	203	1344	19	2	10	1	1	1	1	9	3	3	1597	18	376
471911	경상북도	의성군	구천면	1468	1230	181	991	19	0	10	1	0	0	4	2	3	1	1212	18	238
471912	경상북도	의성군	단밀면	1396	1168	152	966	17	0	7	0	0	0	2	4	3	2	1153	15	228
471913	경상북도	의성군	단북면	1482	1258	136	1069	12	1	11	1	0	2	2	3	5	1	1243	15	224
471914	경상북도	의성군	안계면	3798	3092	439	2528	43	1	32	0	3	0	5	7	2	1	3061	31	706
471915	경상북도	의성군	다인면	3045	2491	358	2025	28	1	22	0	1	0	7	5	10	2	2459	32	554
471916	경상북도	의성군	신평면	675	567	91	449	5	1	3	0	0	2	2	4	3	1	561	6	108
471917	경상북도	의성군	안평면	1795	1475	205	1216	14	0	10	1	2	0	1	3	5	2	1459	16	320
471918	경상북도	의성군	안사면	727	631	94	480	9	0	10	2	2	1	2	2	7	3	612	19	96
472001	경상북도	청송군	청송읍	4220	3401	702	2557	67	1	18	1	0	2	10	4	8	3	3373	28	819
472003	경상북도	청송군	부남면	2181	1803	320	1398	25	5	17	0	1	0	6	6	8	3	1789	14	378
472004	경상북도	청송군	현동면	1779	1447	232	1173	14	0	8	0	0	0	6	2	1	1	1437	10	332
472005	경상북도	청송군	현서면	2065	1726	306	1349	21	0	21	0	0	0	0	2	11	2	1712	14	339
472006	경상북도	청송군	안덕면	2083	1613	295	1237	17	1	16	0	2	2	14	10	8	0	1602	11	470
472007	경상북도	청송군	파천면	1504	1224	212	964	24	1	3	0	0	0	2	0	4	0	1210	14	280
472008	경상북도	청송군	진보면	5124	4063	860	3058	50	3	35	2	1	0	4	3	8	2	4026	37	1061
472009	경상북도	청송군	주왕산면	1418	1143	189	901	22	0	10	2	0	0	4	1	3	0	1132	11	275
472101	경상북도	영양군	영양읍	5539	4433	1036	3238	76	4	24	1	0	3	2	1	8	5	4398	35	1106
472102	경상북도	영양군	입암면	1788	1453	288	1114	20	4	9	0	0	1	4	2	1	2	1445	8	335
472103	경상북도	영양군	청기면	1458	1180	228	900	18	1	4	0	0	0	2	2	6	1	1162	18	278
472104	경상북도	영양군	일월면	1566	1250	303	896	21	0	11	0	0	1	4	0	5	1	1242	8	316
472105	경상북도	영양군	수비면	1341	1085	258	788	20	1	1	1	0	0	2	3	3	1	1078	7	256
472106	경상북도	영양군	석보면	1724	1448	327	1064	18	0	9	1	0	0	1	1	9	0	1430	18	276
472201	경상북도	영덕군	영덕읍	8480	6704	1272	5208	89	2	42	3	1	1	19	6	9	2	6654	50	1776
472202	경상북도	영덕군	강구면	5098	3870	558	3200	27	4	31	1	0	2	4	2	0	2	3831	39	1228
472203	경상북도	영덕군	남정면	1957	1533	214	1261	16	1	7	0	0	1	4	2	5	5	1516	17	424
472204	경상북도	영덕군	달산면	916	743	110	604	9	2	3	2	0	0	1	0	4	3	738	5	173
472205	경상북도	영덕군	지품면	1676	1404	221	1118	22	1	11	1	0	1	3	0	4	2	1384	20	272
472206	경상북도	영덕군	축산면	2198	1752	222	1484	13	2	7	1	0	0	0	2	5	1	1737	15	446
472207	경상북도	영덕군	영해면	5347	4141	675	3340	43	1	25	1	0	1	2	1	7	2	4098	43	1206
472208	경상북도	영덕군	병곡면	2227	1761	196	1499	18	1	9	2	1	0	2	1	6	3	1738	23	466
472209	경상북도	영덕군	창수면	1432	1179	190	932	12	0	14	1	1	1	3	1	6	1	1162	17	253
472301	경상북도	봉화군	봉화읍	7785	6099	1439	4420	111	3	39	2	0	2	13	4	10	6	6049	50	1686
472302	경상북도	봉화군	물야면	2412	1873	387	1418	24	0	12	1	1	0	0	1	7	1	1852	21	539
472303	경상북도	봉화군	봉성면	1739	1392	245	1086	17	1	12	2	0	1	2	3	8	2	1379	13	347
472304	경상북도	봉화군	법전면	1615	1265	252	954	9	0	18	0	0	0	4	3	5	2	1247	18	350
472305	경상북도	봉화군	춘양면	3854	3128	617	2360	61	4	32	0	0	1	10	2	13	2	3102	26	726
472306	경상북도	봉화군	소천면	1753	1387	305	1010	15	2	16	0	0	2	8	1	8	1	1368	19	366
472307	경상북도	봉화군	석포면	1534	1165	305	810	19	0	16	0	1	0	1	1	4	1	1158	7	369
472308	경상북도	봉화군	재산면	1240	968	256	658	13	1	10	0	4	0	3	0	8	4	957	11	272
472309	경상북도	봉화군	명호면	1683	1311	287	964	18	1	13	0	1	3	1	4	7	2	1301	10	372
472310	경상북도	봉화군	상운면	1479	1193	197	960	13	0	6	1	0	1	2	0	5	1	1186	7	286
472401	경상북도	울진군	울진읍	10167	7909	1809	5807	123	0	71	1	0	1	19	8	8	3	7850	59	2258
472402	경상북도	울진군	평해읍	2402	1873	287	1524	26	0	7	1	0	1	5	4	4	3	1862	11	529
472403	경상북도	울진군	북면	5368	4221	964	3096	74	1	23	1	2	0	6	5	7	1	4180	41	1147
472404	경상북도	울진군	금강송면	1093	835	146	624	12	3	17	0	1	1	8	1	8	3	824	11	258
472405	경상북도	울진군	근남면	2562	2075	441	1554	24	2	16	0	0	0	4	5	0	4	2050	25	487
472406	경상북도	울진군	매화면	1867	1453	265	1128	13	1	10	1	0	2	3	3	5	2	1433	20	414
472407	경상북도	울진군	기성면	2085	1624	273	1276	21	0	9	1	0	2	2	2	6	4	1596	28	461
472408	경상북도	울진군	온정면	1474	1196	163	988	8	1	10	0	0	0	6	0	2	5	1183	13	278
472409	경상북도	울진군	죽변면	5226	3835	681	3035	43	2	20	0	1	1	4	3	3	3	3796	39	1391
472410	경상북도	울진군	후포면	6115	4664	790	3700	44	4	41	4	0	1	2	5	4	7	4602	62	1451
480301	경상남도	진주시	문산읍	7378	5619	1882	3428	125	4	75	4	2	0	6	14	2	11	5553	66	1759
480302	경상남도	진주시	내동면	3620	3044	1048	1871	70	0	26	0	0	0	0	13	4	0	3032	12	576
480303	경상남도	진주시	정촌면	7095	5529	1908	3315	140	2	89	2	0	0	3	11	3	7	5480	49	1566
480304	경상남도	진주시	금곡면	2017	1533	359	1090	22	0	16	0	2	1	2	17	3	1	1513	20	484
480305	경상남도	진주시	진성면	1819	1422	389	948	37	0	13	2	0	0	0	13	3	0	1405	17	397
480306	경상남도	진주시	일반성면	2548	2037	553	1384	44	4	20	2	0	0	0	3	4	4	2018	19	511
480307	경상남도	진주시	이반성면	1358	1041	287	701	18	3	8	0	0	0	0	1	3	1	1022	19	317
480308	경상남도	진주시	사봉면	1387	1087	330	711	17	2	11	3	1	1	0	2	0	1	1079	8	300
480309	경상남도	진주시	지수면	1274	988	305	588	28	1	31	1	0	0	4	14	2	2	976	12	286
480310	경상남도	진주시	대곡면	3037	2293	600	1573	47	0	26	4	1	0	2	5	3	5	2266	27	744
480311	경상남도	진주시	금산면	14870	11319	4245	6504	265	6	135	3	0	0	3	48	4	7	11220	99	3551
480312	경상남도	진주시	집현면	3791	2785	762	1881	53	0	32	1	2	1	1	9	5	2	2749	36	1006
480313	경상남도	진주시	미천면	1327	1000	214	731	21	1	7	0	0	0	2	3	6	2	987	13	327
480314	경상남도	진주시	명석면	3623	2798	640	2037	52	0	23	0	1	0	1	9	6	3	2772	26	825
480315	경상남도	진주시	대평면	977	793	209	538	11	1	11	1	0	0	0	2	1	1	775	18	184
480316	경상남도	진주시	수곡면	2034	1603	467	1078	19	0	11	0	0	0	0	4	4	3	1586	17	431
480321	경상남도	진주시	중앙동	10040	7435	1694	5408	128	3	93	1	0	3	11	16	3	4	7364	71	2605
480331	경상남도	진주시	상평동	9951	7614	2230	5002	184	1	90	0	2	1	10	21	2	5	7548	66	2337
480332	경상남도	진주시	초장동	18554	14657	5456	8465	410	5	145	0	2	2	9	28	2	6	14530	127	3897
480333	경상남도	진주시	평거동	19865	15073	5290	9063	378	4	129	5	1	3	17	14	5	4	14913	160	4792
480334	경상남도	진주시	신안동	10037	7920	2251	5352	157	2	77	0	1	2	5	14	1	2	7864	56	2117
480335	경상남도	진주시	이현동	9108	6900	1977	4607	143	0	85	5	0	3	5	13	4	7	6849	51	2208
480336	경상남도	진주시	판문동	14676	11472	4313	6586	312	7	92	5	5	0	11	20	5	6	11362	110	3204
480337	경상남도	진주시	가호동	21265	16323	5901	9438	491	10	177	3	0	1	12	37	5	7	16082	241	4942
480338	경상남도	진주시	천전동	21881	16724	4903	11053	341	6	145	4	4	4	20	27	8	9	16524	200	5157
480339	경상남도	진주시	성북동	8641	6009	1481	4241	99	3	85	0	2	1	8	11	6	1	5938	71	2632
480340	경상남도	진주시	상봉동	12114	8945	2310	6224	164	2	126	5	1	0	12	10	7	5	8866	79	3169
480341	경상남도	진주시	충무공동	20898	16794	7372	8543	555	6	124	4	2	3	5	34	2	4	16654	140	4104
480342	경상남도	진주시	상대동	16977	12543	3626	8298	277	7	168	4	1	2	1	24	9	6	12423	120	4434
480343	경상남도	진주시	하대동	19872	14622	4323	9555	335	10	181	2	3	0	23	37	4	4	14477	145	5250
480501	경상남도	통영시	산양읍	3709	2666	728	1812	40	0	40	2	0	0	6	6	7	3	2644	22	1043
480502	경상남도	통영시	용남면	9116	6609	2232	4045	132	2	118	1	2	1	2	13	6	5	6559	50	2507
480503	경상남도	통영시	도산면	2783	2209	670	1424	30	2	40	1	0	0	2	15	3	0	2187	22	574
480504	경상남도	통영시	광도면	21114	15163	6058	8369	332	7	224	3	0	5	17	23	11	7	15056	107	5951
480505	경상남도	통영시	욕지면	1527	1127	336	736	20	1	17	0	0	0	1	4	1	2	1118	9	400
480506	경상남도	통영시	한산면	1450	1102	214	827	14	1	10	0	0	0	4	1	5	3	1079	23	348
480507	경상남도	통영시	사량면	1226	946	253	638	14	2	13	0	0	0	1	4	3	2	930	16	280
480508	경상남도	통영시	도천동	7099	5092	1350	3490	100	0	74	1	0	2	4	12	8	9	5050	42	2007
480509	경상남도	통영시	명정동	2949	2312	608	1617	28	1	14	2	1	1	4	2	3	2	2283	29	637
480510	경상남도	통영시	중앙동	3676	2749	690	1971	38	3	17	2	0	1	4	2	0	1	2729	20	927
480511	경상남도	통영시	정량동	7520	5444	1469	3739	79	3	74	3	1	3	10	12	5	3	5401	43	2076
480512	경상남도	통영시	북신동	8025	6027	1627	4145	117	3	73	0	2	1	6	3	4	2	5983	44	1998
480513	경상남도	통영시	무전동	11359	8568	2949	5246	171	3	98	2	1	2	4	15	6	2	8499	69	2791
480515	경상남도	통영시	미수동	8447	6251	2151	3773	132	0	105	2	2	1	7	12	3	3	6191	60	2196
480517	경상남도	통영시	봉평동	8654	6195	2000	3894	128	2	85	1	0	0	11	10	5	3	6139	56	2459
480601	경상남도	고성군	고성읍	18410	13290	4371	8257	260	4	211	6	2	3	16	11	16	10	13167	123	5120
480602	경상남도	고성군	삼산면	1425	1097	329	724	15	0	7	1	1	2	2	1	3	1	1086	11	328
480603	경상남도	고성군	하일면	1527	1141	208	890	13	0	8	0	0	1	0	5	3	3	1131	10	386
480604	경상남도	고성군	하이면	2088	1606	388	1129	32	0	24	2	0	1	7	5	1	3	1592	14	482
480605	경상남도	고성군	상리면	1367	1067	324	698	18	0	9	1	1	0	2	0	1	3	1057	10	300
480606	경상남도	고성군	대가면	1520	1170	322	774	35	0	20	0	1	0	2	2	3	2	1161	9	350
480607	경상남도	고성군	영현면	720	586	158	399	12	2	4	0	0	0	0	1	1	0	577	9	134
480608	경상남도	고성군	영오면	1174	880	220	610	20	1	15	0	2	0	0	0	1	1	870	10	294
480609	경상남도	고성군	개천면	871	682	161	500	8	2	3	0	0	0	1	0	0	0	675	7	189
480610	경상남도	고성군	구만면	877	684	239	417	9	1	7	0	0	0	2	0	1	2	678	6	193
480611	경상남도	고성군	회화면	2965	2289	564	1633	31	2	30	0	0	0	2	4	2	0	2268	21	676
480612	경상남도	고성군	마암면	1377	986	249	671	26	2	18	0	0	0	0	4	4	1	975	11	391
480613	경상남도	고성군	동해면	2417	1768	456	1215	30	2	23	0	1	1	4	2	5	1	1740	28	649
480614	경상남도	고성군	거류면	3621	2589	692	1762	40	4	43	3	2	2	1	5	7	2	2563	26	1032
480701	경상남도	사천시	사천읍	14305	10481	3728	6211	251	3	143	3	1	1	9	22	6	4	10382	99	3824
480702	경상남도	사천시	정동면	8527	6027	2198	3462	163	6	90	2	0	1	4	21	7	2	5956	71	2500
480703	경상남도	사천시	사남면	10899	8220	3331	4448	209	3	105	3	2	1	6	26	5	4	8143	77	2679
480704	경상남도	사천시	용현면	5746	4222	1383	2636	92	0	56	2	2	1	3	5	7	3	4190	32	1524
480705	경상남도	사천시	축동면	1690	1383	366	950	30	1	15	1	0	2	1	1	2	2	1371	12	307
480706	경상남도	사천시	곤양면	2935	2279	604	1557	37	0	24	2	3	2	2	8	4	7	2250	29	656
480707	경상남도	사천시	곤명면	2261	1733	433	1230	33	0	14	0	0	0	0	1	4	0	1715	18	528
480708	경상남도	사천시	서포면	2973	2122	549	1487	26	2	17	0	0	1	2	2	5	7	2098	24	851
480709	경상남도	사천시	동서동	5204	3827	725	2956	47	4	32	0	0	1	4	1	7	8	3785	42	1377
480710	경상남도	사천시	선구동	4166	3029	760	2146	51	0	34	1	0	0	4	4	0	0	3000	29	1137
480711	경상남도	사천시	동서금동	5064	3743	974	2618	55	0	46	0	0	1	3	3	2	4	3706	37	1321
480712	경상남도	사천시	벌용동	12569	9363	2982	5922	230	6	99	3	3	1	14	25	3	6	9294	69	3206
480713	경상남도	사천시	향촌동	5593	4118	1336	2564	82	2	60	1	2	1	2	10	4	2	4066	52	1475
480714	경상남도	사천시	남양동	4361	3369	1026	2171	66	4	44	1	0	1	3	10	5	4	3335	34	992
480801	경상남도	김해시	진영읍	40381	28386	14161	12578	803	12	467	2	4	4	33	42	8	21	28135	251	11995
480803	경상남도	김해시	주촌면	14352	11016	5044	5421	293	6	129	0	3	2	2	9	3	3	10915	101	3336
480804	경상남도	김해시	진례면	6020	4516	1805	2511	64	4	85	1	0	0	2	10	3	5	4490	26	1504
480805	경상남도	김해시	한림면	6500	4738	1966	2544	79	6	56	2	1	1	1	4	9	5	4674	64	1762
480806	경상남도	김해시	생림면	3857	2964	1083	1763	55	2	34	1	0	0	1	1	2	0	2942	22	893
480807	경상남도	김해시	상동면	2857	2202	772	1337	31	1	31	0	0	0	4	3	2	1	2182	20	655
480808	경상남도	김해시	대동면	4771	3590	1148	2304	55	0	35	0	1	1	7	5	0	2	3558	32	1181
480809	경상남도	김해시	동상동	8807	6222	2422	3492	135	5	96	1	0	2	5	10	3	3	6174	48	2585
480810	경상남도	김해시	회현동	8946	7010	2851	3822	169	2	83	0	1	6	6	5	2	2	6949	61	1936
480811	경상남도	김해시	부원동	9396	6962	2964	3663	178	1	85	0	1	2	7	3	2	0	6906	56	2434
480812	경상남도	김해시	내외동	56964	39040	17565	19311	1028	29	568	11	8	6	27	57	15	17	38642	398	17924
480813	경상남도	김해시	북부동	58776	42225	19552	20407	1187	10	557	11	3	12	35	56	11	20	41861	364	16551
480814	경상남도	김해시	칠산서부동	9007	6811	2941	3570	146	1	75	1	0	4	6	9	2	4	6759	52	2196
480815	경상남도	김해시	활천동	30152	19944	8655	10212	472	14	314	7	6	5	13	19	2	6	19725	219	10208
480816	경상남도	김해시	삼안동	28779	20339	8899	10285	504	18	310	8	2	4	19	30	7	12	20098	241	8440
480817	경상남도	김해시	불암동	6472	4900	2213	2456	114	2	55	2	0	0	4	7	1	2	4856	44	1572
480818	경상남도	김해시	장유1동	40157	28975	13809	13590	810	10	394	7	4	2	30	24	15	10	28705	270	11182
480819	경상남도	김해시	장유2동	27730	20615	10317	9258	544	8	252	2	1	3	9	27	7	5	20433	182	7115
480820	경상남도	김해시	장유3동	48787	36951	18561	16628	1035	6	350	7	4	2	22	43	2	9	36669	282	11836
480901	경상남도	밀양시	삼랑진읍	5420	3858	1035	2664	54	1	48	1	1	1	1	7	2	3	3818	40	1562
480902	경상남도	밀양시	하남읍	6152	4487	1360	2916	81	3	60	3	1	0	3	5	5	5	4442	45	1665
480903	경상남도	밀양시	부북면	4435	3344	897	2320	50	0	36	1	0	1	5	3	3	0	3316	28	1091
480904	경상남도	밀양시	상동면	2666	2102	590	1418	39	0	18	1	0	1	7	0	3	7	2084	18	564
480905	경상남도	밀양시	산외면	2587	2021	577	1367	24	1	16	0	0	2	3	4	2	1	1997	24	566
480906	경상남도	밀양시	산내면	3157	2424	670	1650	39	1	31	2	1	1	1	4	1	2	2403	21	733
480907	경상남도	밀양시	단장면	3555	2713	716	1877	37	2	31	1	0	2	1	12	3	4	2686	27	842
480908	경상남도	밀양시	상남면	6404	4475	1255	2989	96	1	50	2	0	1	5	16	8	6	4429	46	1929
480909	경상남도	밀양시	초동면	2693	2029	541	1413	25	1	17	1	1	2	5	3	1	3	2013	16	664
480910	경상남도	밀양시	무안면	4181	3139	773	2242	38	2	27	1	1	0	5	7	3	3	3102	37	1042
480911	경상남도	밀양시	청도면	1583	1256	359	832	21	3	11	1	1	0	4	0	7	2	1241	15	327
480912	경상남도	밀양시	내일동	2992	2349	588	1676	43	1	20	0	0	0	1	3	3	2	2337	12	643
480913	경상남도	밀양시	내이동	11181	7508	2459	4658	172	4	119	4	1	2	12	9	5	6	7451	57	3673
480914	경상남도	밀양시	교동	6531	5255	1934	3037	145	2	72	0	0	1	2	16	0	3	5212	43	1276
480915	경상남도	밀양시	삼문동	14600	10919	3928	6466	263	4	124	3	2	3	7	21	3	4	10828	91	3681
480916	경상남도	밀양시	가곡동	6794	4985	1666	3063	103	3	74	2	0	2	4	9	4	5	4935	50	1809
481002	경상남도	거제시	일운면	6482	4755	1907	2584	108	0	88	4	1	1	2	11	0	3	4709	46	1727
481003	경상남도	거제시	동부면	2723	2148	633	1426	30	2	21	1	1	0	3	5	3	0	2125	23	575
481004	경상남도	거제시	남부면	1334	1001	273	689	11	0	9	0	0	0	2	5	1	0	990	11	333
481005	경상남도	거제시	거제면	6227	4629	1634	2760	72	3	82	4	3	3	5	10	9	7	4592	37	1598
481006	경상남도	거제시	둔덕면	2548	1983	544	1339	41	1	29	0	0	2	0	1	1	5	1963	20	565
481007	경상남도	거제시	사등면	9172	6635	2274	3940	166	8	133	4	3	1	10	24	3	6	6572	63	2537
481008	경상남도	거제시	연초면	6659	4718	1787	2615	130	1	111	0	5	1	9	8	5	2	4674	44	1941
481009	경상남도	거제시	하청면	3897	2934	913	1869	65	2	45	2	2	0	2	8	1	4	2913	21	963
481010	경상남도	거제시	장목면	3856	2800	666	2001	38	0	40	0	2	3	4	11	4	2	2771	29	1056
481011	경상남도	거제시	장승포동	5063	3685	1668	1767	113	4	73	2	2	0	6	6	2	1	3644	41	1378
481013	경상남도	거제시	능포동	7155	5239	2477	2440	170	3	79	3	0	2	1	13	2	1	5191	48	1916
481014	경상남도	거제시	아주동	17799	12931	7287	4711	482	4	252	8	2	0	8	37	2	8	12801	130	4868
481015	경상남도	거제시	옥포1동	6855	5251	2456	2484	137	3	95	4	0	0	6	18	2	1	5206	45	1604
481016	경상남도	거제시	옥포2동	18811	13029	6215	5940	396	12	268	8	6	0	12	29	2	12	12900	129	5782
481017	경상남도	거제시	장평동	16808	11781	5236	5768	356	6	257	5	2	4	14	18	5	6	11677	104	5027
481018	경상남도	거제시	고현동	25456	18436	7602	9688	521	7	360	7	4	3	21	31	15	6	18265	171	7020
481019	경상남도	거제시	상문동	21839	15824	7982	6803	527	6	310	3	3	1	7	35	7	7	15691	133	6015
481020	경상남도	거제시	수양동	15958	12540	6110	5723	370	4	200	5	5	3	2	28	4	3	12457	83	3418
481101	경상남도	의령군	의령읍	7179	5456	1822	3370	106	3	70	1	1	0	6	13	3	5	5400	56	1723
481102	경상남도	의령군	가례면	1527	1131	311	724	16	2	8	2	0	0	0	11	7	4	1085	46	396
481103	경상남도	의령군	칠곡면	1003	791	237	516	13	0	4	0	0	0	0	6	1	4	781	10	212
481104	경상남도	의령군	대의면	835	663	154	465	14	1	8	0	1	0	0	4	1	3	651	12	172
481105	경상남도	의령군	화정면	1192	918	232	640	13	0	15	0	0	0	6	5	2	0	913	5	274
481106	경상남도	의령군	용덕면	1234	941	226	667	15	1	10	0	0	0	3	2	2	1	927	14	293
481107	경상남도	의령군	정곡면	1171	860	209	596	15	3	8	2	0	1	1	0	7	3	845	15	311
481108	경상남도	의령군	지정면	1485	1102	311	733	16	3	7	0	0	1	1	4	1	4	1081	21	383
481109	경상남도	의령군	낙서면	615	459	75	358	10	0	2	0	0	0	0	6	2	0	453	6	156
481110	경상남도	의령군	부림면	2484	1869	477	1303	23	4	10	0	0	3	2	11	5	3	1841	28	615
481111	경상남도	의령군	봉수면	737	539	100	404	8	1	5	1	1	0	1	2	5	2	530	9	198
481112	경상남도	의령군	궁류면	956	729	149	520	14	2	9	1	0	1	2	0	6	5	709	20	227
481113	경상남도	의령군	유곡면	954	761	159	552	11	2	9	1	1	0	0	1	3	2	741	20	193
481201	경상남도	함안군	가야읍	13138	9344	3101	5715	223	1	169	4	3	2	11	21	5	7	9262	82	3794
481202	경상남도	함안군	함안면	2133	1630	496	1068	24	1	16	0	0	0	3	2	3	2	1615	15	503
481203	경상남도	함안군	군북면	5027	3655	1000	2437	77	3	69	2	4	1	6	7	6	3	3615	40	1372
481204	경상남도	함안군	법수면	2462	1802	510	1206	30	2	21	1	0	0	3	3	3	1	1780	22	660
481205	경상남도	함안군	대산면	2906	2138	556	1487	34	3	20	3	0	1	1	4	4	4	2117	21	768
481206	경상남도	함안군	칠서면	3859	2704	773	1787	67	1	36	2	1	1	4	7	3	2	2684	20	1155
481207	경상남도	함안군	칠북면	1681	1347	286	1015	16	1	17	2	0	1	0	1	0	1	1340	7	334
481208	경상남도	함안군	칠원읍	13688	10391	3779	6085	251	8	140	3	1	2	16	17	5	3	10310	81	3297
481209	경상남도	함안군	산인면	3057	2542	849	1583	52	1	31	0	1	0	4	6	1	0	2528	14	515
481210	경상남도	함안군	여항면	804	664	175	460	12	0	5	0	1	0	0	2	0	2	657	7	140
481301	경상남도	창녕군	창녕읍	12697	9179	2514	6192	188	5	134	3	1	5	9	18	10	6	9085	94	3518
481302	경상남도	창녕군	남지읍	9477	6947	1978	4668	98	4	94	1	0	1	10	15	7	5	6881	66	2530
481303	경상남도	창녕군	고암면	1658	1275	294	902	33	0	13	0	0	2	4	1	1	1	1251	24	383
481304	경상남도	창녕군	성산면	1303	984	186	760	10	1	4	2	0	0	6	3	6	2	980	4	319
481305	경상남도	창녕군	대합면	3134	2275	438	1743	32	2	22	1	1	0	5	4	1	4	2253	22	859
481306	경상남도	창녕군	이방면	1838	1397	227	1108	16	4	10	2	1	2	2	1	4	1	1378	19	441
481307	경상남도	창녕군	유어면	1645	1269	260	958	14	2	15	0	0	0	2	4	2	0	1257	12	376
481308	경상남도	창녕군	대지면	2287	1757	436	1241	36	1	17	2	0	1	2	2	1	2	1741	16	530
481309	경상남도	창녕군	계성면	1922	1438	322	1047	21	2	16	1	0	0	1	2	4	3	1419	19	484
481310	경상남도	창녕군	영산면	4415	3288	956	2173	61	3	42	1	1	1	10	7	2	0	3257	31	1127
481311	경상남도	창녕군	장마면	1549	1163	297	828	12	0	7	0	0	0	2	1	2	0	1149	14	386
481312	경상남도	창녕군	도천면	2282	1723	425	1208	36	3	15	1	0	0	1	8	1	1	1699	24	559
481313	경상남도	창녕군	길곡면	1237	996	264	698	12	1	8	1	0	0	2	1	2	2	991	5	241
481314	경상남도	창녕군	부곡면	2978	2267	557	1601	38	2	34	1	1	0	2	5	4	2	2247	20	711
481401	경상남도	양산시	물금읍	84461	61945	27357	31551	1574	23	704	10	6	5	36	101	16	26	61409	536	22516
481402	경상남도	양산시	동면	26096	18445	8006	9599	426	6	196	4	4	4	15	27	6	8	18301	144	7651
481403	경상남도	양산시	원동면	2903	2228	539	1612	27	1	24	0	1	0	1	2	3	4	2214	14	675
481404	경상남도	양산시	상북면	11145	8331	2815	5136	159	4	109	2	0	4	8	13	5	7	8262	69	2814
481405	경상남도	양산시	하북면	6923	5130	1568	3364	65	5	65	0	0	3	6	6	2	2	5086	44	1793
481406	경상남도	양산시	중앙동	11229	8036	2805	4877	133	5	113	2	0	0	7	13	5	4	7964	72	3193
481407	경상남도	양산시	양주동	28322	22685	9960	11495	649	8	244	8	2	3	10	56	11	10	22456	229	5637
481408	경상남도	양산시	삼성동	17824	12327	4912	6712	259	10	260	1	1	5	7	18	4	11	12200	127	5497
481409	경상남도	양산시	강서동	6765	4783	2005	2495	139	4	74	3	3	0	4	7	2	1	4737	46	1982
481410	경상남도	양산시	서창동	22301	15837	6703	8278	390	2	257	10	8	3	8	34	6	7	15706	131	6464
481411	경상남도	양산시	소주동	15945	11297	4602	6028	298	8	198	4	1	8	16	18	6	11	11198	99	4648
481412	경상남도	양산시	평산동	22796	15914	6616	8492	376	5	229	6	5	5	25	24	2	10	15795	119	6882
481413	경상남도	양산시	덕계동	15859	12302	5144	6586	284	6	170	1	2	3	15	13	3	4	12231	71	3557
481501	경상남도	하동군	하동읍	7663	6025	2293	3406	155	6	70	3	1	0	6	6	8	2	5956	69	1638
481502	경상남도	하동군	화개면	2424	1947	842	1012	30	0	26	0	0	0	0	4	8	4	1926	21	477
481503	경상남도	하동군	악양면	2821	2194	810	1243	51	5	33	1	1	1	3	5	9	3	2165	29	627
481504	경상남도	하동군	적량면	1630	1278	464	745	30	2	12	0	0	0	1	3	6	1	1264	14	352
481505	경상남도	하동군	횡천면	1597	1279	380	838	25	1	10	0	1	0	1	4	5	1	1266	13	318
481506	경상남도	하동군	고전면	1745	1347	465	812	25	1	16	1	1	0	4	1	7	0	1333	14	398
481507	경상남도	하동군	금남면	2567	2013	653	1233	32	3	36	2	2	0	3	6	6	9	1985	28	554
481508	경상남도	하동군	금성면	2231	1716	592	1030	33	1	15	1	0	0	3	1	4	5	1685	31	515
481509	경상남도	하동군	진교면	4859	3813	1255	2301	98	5	56	0	0	2	7	14	9	6	3753	60	1046
481510	경상남도	하동군	양보면	1423	1150	297	784	25	0	13	1	1	1	0	4	3	2	1131	19	273
481511	경상남도	하동군	북천면	1375	1099	264	769	24	2	11	0	1	1	1	3	8	5	1089	10	276
481512	경상남도	하동군	청암면	1028	844	267	520	6	0	21	0	1	1	1	4	1	9	831	13	184
481513	경상남도	하동군	옥종면	3466	2702	789	1772	62	2	27	0	0	2	2	8	5	4	2673	29	764
481601	경상남도	남해군	남해읍	10461	7957	3002	4491	219	5	97	6	2	4	8	24	5	12	7875	82	2504
481602	경상남도	남해군	이동면	3116	2468	735	1609	58	1	20	2	0	1	4	5	3	0	2438	30	648
481603	경상남도	남해군	상주면	1322	994	349	594	25	0	11	0	0	0	0	1	5	4	989	5	328
481604	경상남도	남해군	삼동면	3224	2455	824	1504	48	3	26	1	0	0	2	3	3	4	2418	37	769
481605	경상남도	남해군	미조면	1952	1512	441	1009	24	2	15	2	0	0	1	0	3	4	1501	11	440
481606	경상남도	남해군	남면	2964	2201	695	1379	48	1	23	4	0	0	4	3	5	2	2164	37	763
481607	경상남도	남해군	서면	2188	1700	501	1111	33	1	12	2	0	2	2	5	3	5	1677	23	488
481608	경상남도	남해군	고현면	2983	2337	895	1305	51	4	29	1	0	2	3	8	5	4	2307	30	646
481609	경상남도	남해군	설천면	2301	1790	580	1128	31	0	13	1	0	1	1	5	2	3	1765	25	511
481610	경상남도	남해군	창선면	4634	3500	809	2516	46	1	44	1	0	2	3	7	5	7	3441	59	1134
481701	경상남도	함양군	함양읍	13648	10097	3391	6236	209	5	117	2	5	0	7	24	10	5	10011	86	3551
481702	경상남도	함양군	마천면	1823	1388	497	814	19	0	17	2	2	2	0	4	14	5	1376	12	435
481703	경상남도	함양군	휴천면	1276	976	317	605	14	1	11	1	0	0	1	3	5	3	961	15	300
481704	경상남도	함양군	유림면	1344	998	258	673	17	2	20	1	0	1	1	4	3	6	986	12	346
481705	경상남도	함양군	수동면	2047	1636	477	1086	29	0	13	0	0	0	1	6	2	1	1615	21	411
481706	경상남도	함양군	지곡면	1940	1558	455	1017	32	3	17	1	1	1	1	3	6	2	1539	19	382
481707	경상남도	함양군	안의면	3934	3057	767	2113	60	5	33	2	2	4	11	4	5	1	3007	50	877
481708	경상남도	함양군	서하면	1139	890	233	618	8	1	11	0	0	0	0	4	4	0	879	11	249
481709	경상남도	함양군	서상면	1566	1232	386	765	28	0	21	0	0	1	7	2	5	2	1217	15	334
481710	경상남도	함양군	백전면	1278	983	306	633	14	2	9	1	0	0	1	5	5	0	976	7	295
481711	경상남도	함양군	병곡면	1147	937	268	609	15	2	15	1	1	1	7	1	3	2	925	12	210
481801	경상남도	산청군	산청읍	5143	3809	1119	2506	82	5	43	1	0	1	4	10	4	3	3778	31	1334
481802	경상남도	산청군	차황면	1178	916	243	634	10	1	5	0	0	2	0	3	4	3	905	11	262
481803	경상남도	산청군	오부면	849	649	157	445	12	2	8	0	0	0	2	6	4	3	639	10	200
481804	경상남도	산청군	생초면	1720	1283	274	953	17	0	5	0	0	1	3	3	4	1	1261	22	437
481805	경상남도	산청군	금서면	2439	1803	506	1201	40	2	12	0	0	0	3	2	5	2	1773	30	636
481806	경상남도	산청군	삼장면	1488	1224	332	854	15	0	8	0	0	1	1	7	0	2	1220	4	264
481807	경상남도	산청군	시천면	3324	2588	753	1727	44	1	27	0	1	0	4	8	0	2	2567	21	736
481808	경상남도	산청군	단성면	4461	3293	866	2276	58	2	25	1	1	1	7	10	8	2	3257	36	1168
481809	경상남도	산청군	신안면	4276	3283	1001	2131	66	2	31	1	1	2	3	11	4	1	3254	29	993
481810	경상남도	산청군	생비량면	957	756	157	555	20	3	3	2	1	0	0	6	1	1	749	7	201
481811	경상남도	산청군	신등면	1808	1416	357	987	17	3	12	3	0	0	0	6	5	2	1392	24	392
481901	경상남도	거창군	거창읍	28943	21108	6477	13625	463	13	231	6	4	4	15	42	15	13	20908	200	7835
481902	경상남도	거창군	주상면	1573	1312	295	958	16	1	11	2	1	2	2	1	1	2	1292	20	261
481903	경상남도	거창군	웅양면	1702	1387	396	890	33	3	18	0	0	0	3	6	5	2	1356	31	315
481904	경상남도	거창군	고제면	1296	1061	295	696	20	2	14	2	0	1	2	9	7	2	1050	11	235
481905	경상남도	거창군	북상면	1314	1037	273	712	19	3	4	2	1	0	0	4	2	2	1022	15	277
481906	경상남도	거창군	위천면	1698	1368	333	952	35	3	23	1	1	0	1	2	1	1	1353	15	330
481907	경상남도	거창군	마리면	2124	1719	435	1187	33	1	31	1	1	1	3	6	1	1	1701	18	405
481908	경상남도	거창군	남상면	2314	1866	453	1301	31	3	19	2	2	1	7	3	6	8	1836	30	448
481909	경상남도	거창군	남하면	1831	1574	415	1076	36	4	20	0	0	1	2	5	4	3	1566	8	257
481910	경상남도	거창군	신원면	1327	1045	234	741	25	3	13	1	1	1	0	0	9	5	1033	12	282
481911	경상남도	거창군	가조면	3444	2825	638	2056	53	3	32	2	1	0	5	5	3	7	2805	20	619
481912	경상남도	거창군	가북면	1121	898	196	661	6	0	15	0	1	0	1	4	6	0	890	8	223
482001	경상남도	합천군	합천읍	8732	6656	1630	4692	141	3	92	0	1	3	5	19	3	5	6594	62	2076
482002	경상남도	합천군	봉산면	1162	897	187	677	7	0	3	1	0	0	1	4	4	3	887	10	265
482003	경상남도	합천군	묘산면	1333	1040	156	834	13	2	11	0	0	3	4	2	1	2	1028	12	293
482004	경상남도	합천군	가야면	3420	2661	622	1932	30	0	19	2	2	2	5	7	5	2	2628	33	759
482005	경상남도	합천군	야로면	1935	1504	268	1163	27	0	9	0	2	0	0	2	4	3	1478	26	431
482006	경상남도	합천군	율곡면	1907	1423	245	1104	21	3	11	2	0	1	5	6	4	1	1403	20	484
482007	경상남도	합천군	초계면	2051	1551	320	1172	17	3	15	1	0	1	1	3	1	2	1536	15	500
482008	경상남도	합천군	쌍책면	1062	878	128	697	12	1	8	0	0	0	5	8	3	5	867	11	184
482009	경상남도	합천군	덕곡면	726	583	85	472	7	0	4	1	0	0	0	1	2	0	572	11	143
482010	경상남도	합천군	청덕면	1286	939	138	743	15	2	8	1	1	2	6	1	5	1	923	16	347
482011	경상남도	합천군	적중면	1171	905	161	683	12	1	15	1	0	0	4	3	4	4	888	17	266
482012	경상남도	합천군	대양면	1357	977	228	697	27	0	10	0	0	0	2	3	1	0	968	9	380
482013	경상남도	합천군	쌍백면	1470	1107	213	830	14	1	11	3	1	0	2	3	7	5	1090	17	363
482014	경상남도	합천군	삼가면	2724	2046	453	1480	34	4	20	0	0	1	3	6	0	5	2006	40	678
482015	경상남도	합천군	가회면	1375	1062	246	760	16	0	6	2	0	0	2	7	3	2	1044	18	313
482016	경상남도	합천군	대병면	1643	1233	268	895	11	4	17	2	0	0	3	4	5	5	1214	19	410
482017	경상남도	합천군	용주면	1835	1413	301	1032	21	1	10	1	0	0	7	7	11	5	1396	17	422
482101	경상남도	창원시의창구	동읍	15577	11620	4400	6590	288	3	169	5	1	2	13	24	3	6	11504	116	3957
482102	경상남도	창원시의창구	북면	29996	22460	8928	12454	584	11	239	8	3	5	24	31	3	8	22298	162	7536
482103	경상남도	창원시의창구	대산면	6103	4425	1575	2636	77	1	59	1	0	0	7	5	3	5	4369	56	1678
482104	경상남도	창원시의창구	의창동	37007	28093	9376	17245	761	11	336	4	2	0	29	39	10	12	27825	268	8914
482105	경상남도	창원시의창구	팔룡동	20703	15838	6055	8922	479	8	173	6	3	1	7	24	7	7	15692	146	4865
482106	경상남도	창원시의창구	명곡동	33825	25090	8739	14977	640	15	366	14	2	6	27	54	5	6	24851	239	8735
482107	경상남도	창원시의창구	봉림동	24050	17415	6156	10263	420	7	254	8	5	6	23	63	7	9	17221	194	6635
482201	경상남도	창원시성산구	반송동	30064	24106	9304	13588	746	7	191	8	6	2	18	35	4	9	23918	188	5958
482202	경상남도	창원시성산구	중앙동	26909	19244	7243	10938	531	11	251	7	1	4	26	32	7	9	19060	184	7665
482203	경상남도	창원시성산구	상남동	22820	18370	7374	10066	549	3	193	4	2	4	11	24	9	6	18245	125	4450
482204	경상남도	창원시성산구	사파동	34883	27115	11318	14090	995	10	328	8	5	8	30	50	6	13	26861	254	7768
482205	경상남도	창원시성산구	가음정동	30911	24500	10195	12890	820	12	257	8	2	1	15	43	11	15	24269	231	6411
482206	경상남도	창원시성산구	성주동	18521	14766	6142	7829	443	6	146	8	3	3	9	28	4	7	14628	138	3755
482207	경상남도	창원시성산구	웅남동	6332	5002	1847	2848	138	1	90	1	3	0	8	4	0	2	4942	60	1330
482208	경상남도	창원시성산구	용지동	22760	17269	6188	10105	540	3	181	9	3	10	17	20	4	6	17086	183	5491
482301	경상남도	창원시마산합포구	구산면	3472	2547	590	1870	22	0	16	2	0	3	2	3	4	4	2516	31	925
482302	경상남도	창원시마산합포구	진동면	9745	7209	2310	4556	140	2	117	2	0	2	5	10	4	7	7155	54	2536
482303	경상남도	창원시마산합포구	진북면	2943	2080	500	1470	39	2	31	0	1	1	2	5	3	3	2057	23	863
482304	경상남도	창원시마산합포구	진전면	3190	2428	508	1807	40	3	24	5	0	0	3	0	8	1	2399	29	762
482305	경상남도	창원시마산합포구	현동	10459	8310	3169	4743	209	2	96	1	1	0	8	11	7	2	8249	61	2149
482306	경상남도	창원시마산합포구	가포동	1919	1576	614	888	35	1	21	0	1	0	2	3	1	1	1567	9	343
482307	경상남도	창원시마산합포구	월영동	29920	22926	7906	13964	554	6	250	5	3	6	21	28	5	7	22755	171	6994
482308	경상남도	창원시마산합포구	문화동	9619	7189	2068	4818	141	1	75	2	3	1	10	8	1	1	7129	60	2430
482311	경상남도	창원시마산합포구	완월동	8023	6071	1752	4037	132	1	67	0	0	3	5	17	3	3	6020	51	1952
482312	경상남도	창원시마산합포구	자산동	8581	6479	1740	4436	122	3	91	2	1	2	18	9	4	1	6429	50	2102
482315	경상남도	창원시마산합포구	교방동	12300	9300	2776	6076	215	3	110	4	1	2	6	8	6	6	9213	87	3000
482318	경상남도	창원시마산합포구	합포동	6726	5041	1561	3268	98	1	56	0	2	0	7	7	0	1	5001	40	1685
482319	경상남도	창원시마산합포구	산호동	10163	7445	2180	4902	157	5	99	4	0	3	11	4	6	3	7374	71	2718
482320	경상남도	창원시마산합포구	반월중앙동	11516	8788	2562	5829	194	3	89	2	1	1	12	9	3	7	8712	76	2728
482321	경상남도	창원시마산합포구	오동동	15556	11012	2828	7727	183	3	137	2	1	2	19	11	6	5	10924	88	4544
482401	경상남도	창원시마산회원구	내서읍	46491	35307	13331	20128	882	28	470	5	5	5	23	74	10	12	34973	334	11184
482402	경상남도	창원시마산회원구	회원1동	8977	6777	1734	4717	142	2	62	3	1	0	14	12	3	5	6695	82	2200
482403	경상남도	창원시마산회원구	회원2동	7598	5619	1634	3720	127	2	67	1	0	1	9	3	0	3	5567	52	1979
482406	경상남도	창원시마산회원구	회성동	5443	4059	1034	2832	82	6	41	2	1	0	4	7	1	4	4014	45	1384
482407	경상남도	창원시마산회원구	양덕1동	9005	6571	1928	4308	133	6	111	1	0	0	9	13	1	2	6512	59	2434
482408	경상남도	창원시마산회원구	양덕2동	22392	17778	5795	11216	393	4	174	3	1	5	13	21	4	4	17633	145	4614
482409	경상남도	창원시마산회원구	합성1동	7705	5833	1844	3743	118	3	63	0	0	1	12	8	1	1	5794	39	1872
482410	경상남도	창원시마산회원구	합성2동	6862	5054	1367	3422	104	3	75	2	2	2	10	7	4	3	5001	53	1808
482411	경상남도	창원시마산회원구	구암1동	7633	5854	1824	3727	119	0	110	0	1	1	9	7	1	2	5801	53	1779
482412	경상남도	창원시마산회원구	구암2동	7198	5389	1783	3315	140	2	72	1	1	0	7	9	2	1	5333	56	1809
482413	경상남도	창원시마산회원구	봉암동	2961	2139	661	1380	32	2	32	2	0	0	2	1	1	0	2113	26	822
482414	경상남도	창원시마산회원구	석전동	13752	10453	3181	6758	225	8	137	5	4	0	11	14	2	5	10350	103	3299
482503	경상남도	창원시진해구	충무동	12536	9215	2926	5808	208	2	123	3	0	3	10	22	5	11	9121	94	3321
482504	경상남도	창원시진해구	여좌동	7196	5390	1551	3590	116	3	59	2	0	1	6	11	1	3	5343	47	1806
482505	경상남도	창원시진해구	태백동	3793	2789	818	1844	56	1	39	1	1	2	4	8	1	0	2775	14	1004
482506	경상남도	창원시진해구	경화동	8783	6627	2287	3956	174	4	108	1	2	4	12	20	8	0	6576	51	2156
482507	경상남도	창원시진해구	병암동	5699	4083	1431	2428	102	0	67	1	4	2	3	3	0	5	4046	37	1616
482508	경상남도	창원시진해구	석동	12959	9933	3945	5497	251	5	116	3	0	4	2	16	3	2	9844	89	3026
482509	경상남도	창원시진해구	이동	7058	4985	1523	3191	107	3	86	4	1	3	9	9	1	3	4940	45	2073
482510	경상남도	창원시진해구	자은동	15414	11675	4778	6292	331	6	130	1	2	1	8	21	2	4	11576	99	3739
482511	경상남도	창원시진해구	덕산동	8054	6061	2131	3565	167	3	109	4	0	0	9	12	0	2	6002	59	1993
482512	경상남도	창원시진해구	풍호동	17300	13316	5206	7387	405	1	165	4	1	5	5	23	5	10	13217	99	3984
482513	경상남도	창원시진해구	웅천동	9315	6702	2574	3766	176	2	104	1	1	0	5	15	2	1	6647	55	2613
482514	경상남도	창원시진해구	웅동1동	5742	3980	1491	2273	92	1	72	1	0	3	0	9	4	4	3950	30	1762
482515	경상남도	창원시진해구	웅동2동	32069	21037	9945	9930	479	13	419	13	3	5	15	21	5	9	20857	180	11032
490101	제주특별자치도	제주시	한림읍	17056	11666	5958	5105	331	12	95	4	2	2	6	14	12	13	11554	112	5390
490102	제주특별자치도	제주시	애월읍	25993	17885	9530	7301	601	9	189	11	2	10	13	25	12	16	17719	166	8108
490103	제주특별자치도	제주시	구좌읍	12024	8379	4026	3904	232	2	55	5	2	3	8	11	13	15	8276	103	3645
490104	제주특별자치도	제주시	조천읍	19414	13832	7116	5891	478	11	104	5	5	6	10	23	15	12	13676	156	5582
490105	제주특별자치도	제주시	한경면	7409	5282	2749	2276	136	3	32	2	1	0	4	6	9	9	5227	55	2127
490106	제주특별자치도	제주시	추자면	1257	877	452	373	18	0	8	1	0	1	2	0	5	1	861	16	380
490107	제주특별자치도	제주시	우도면	1347	940	453	447	19	0	9	0	0	0	1	0	1	3	933	7	407
490108	제주특별자치도	제주시	일도1동	2822	2066	1060	898	55	3	16	2	0	0	3	4	0	2	2043	23	756
490109	제주특별자치도	제주시	일도2동	24471	17564	9088	7538	602	8	110	5	3	4	19	26	4	5	17412	152	6907
490110	제주특별자치도	제주시	이도1동	6405	4539	2290	2023	146	0	25	0	0	0	6	3	2	3	4498	41	1866
490111	제주특별자치도	제주시	이도2동	36374	25730	13508	10679	1007	17	190	5	1	5	13	35	9	11	25480	250	10644
490112	제주특별자치도	제주시	삼도1동	11001	7840	3971	3475	226	5	61	1	1	0	2	5	5	7	7759	81	3161
490113	제주특별자치도	제주시	삼도2동	6665	4630	2344	2024	154	3	44	2	1	2	3	2	0	3	4582	48	2035
490114	제주특별자치도	제주시	용담1동	5482	3628	1861	1554	123	4	32	4	0	0	2	5	3	2	3590	38	1854
490115	제주특별자치도	제주시	용담2동	11187	7671	3893	3335	233	3	88	0	2	1	10	7	4	5	7581	90	3516
490116	제주특별자치도	제주시	건입동	7832	5735	3075	2371	157	8	56	1	2	1	3	6	4	2	5686	49	2097
490117	제주특별자치도	제주시	화북동	17638	12688	7077	4838	463	11	111	7	5	5	16	19	6	8	12566	122	4950
490118	제주특별자치도	제주시	삼양동	18585	13544	8050	4785	450	10	91	5	2	1	6	13	10	5	13428	116	5041
490119	제주특별자치도	제주시	봉개동	5786	4609	2546	1803	152	6	48	4	1	2	0	5	2	3	4572	37	1177
490120	제주특별자치도	제주시	아라동	27158	19399	11027	7251	734	7	116	5	1	3	11	49	6	6	19216	183	7759
490121	제주특별자치도	제주시	오라동	14847	11583	6443	4558	378	4	100	5	3	0	4	12	3	5	11515	68	3264
490122	제주특별자치도	제주시	연동	35269	23867	12234	10356	770	11	194	11	4	9	16	23	2	7	23637	230	11402
490123	제주특별자치도	제주시	노형동	39969	28076	14986	11598	934	20	211	2	2	6	9	33	3	15	27819	257	11893
490124	제주특별자치도	제주시	외도동	17787	12929	7883	4318	456	6	114	0	2	6	11	21	4	5	12826	103	4858
490125	제주특별자치도	제주시	이호동	4332	3322	1863	1297	91	0	35	0	0	0	4	5	3	1	3299	23	1010
490126	제주특별자치도	제주시	도두동	3554	2803	1602	1058	89	2	19	0	0	1	2	4	3	2	2782	21	751
490201	제주특별자치도	서귀포시	대정읍	15947	10911	4903	5399	346	3	94	4	0	2	9	17	9	13	10799	112	5036
490202	제주특별자치도	서귀포시	남원읍	14261	9868	4877	4435	284	9	82	4	1	1	4	26	10	15	9748	120	4393
490203	제주특별자치도	서귀포시	성산읍	11857	8152	3407	4363	208	2	58	2	1	1	3	13	8	12	8078	74	3705
490204	제주특별자치도	서귀포시	안덕면	9361	6662	3320	2949	220	6	71	2	0	1	6	7	6	14	6602	60	2699
490205	제주특별자치도	서귀포시	표선면	9843	6966	3225	3358	209	6	56	4	1	0	6	15	7	12	6899	67	2877
490206	제주특별자치도	서귀포시	송산동	3479	2431	1169	1129	80	0	24	1	0	0	1	3	0	1	2408	23	1048
490207	제주특별자치도	서귀포시	정방동	1814	1126	562	506	34	0	13	1	1	0	2	1	0	0	1120	6	688
490208	제주특별자치도	서귀포시	중앙동	3293	2292	1130	1032	64	3	26	0	1	0	3	6	3	1	2269	23	1001
490209	제주특별자치도	서귀포시	천지동	3545	2554	1273	1148	77	2	27	3	1	1	0	4	1	0	2537	17	991
490210	제주특별자치도	서귀포시	효돈동	4733	3551	1729	1626	111	3	39	0	0	0	2	5	4	1	3520	31	1182
490211	제주특별자치도	서귀포시	영천동	4525	3265	1658	1431	100	2	23	3	0	1	4	9	1	8	3240	25	1260
490212	제주특별자치도	서귀포시	동홍동	16428	10861	5879	4401	338	9	93	0	1	1	6	17	7	10	10762	99	5567
490213	제주특별자치도	서귀포시	서홍동	8418	5926	3181	2371	226	3	71	0	4	2	4	3	1	4	5870	56	2492
490214	제주특별자치도	서귀포시	대륜동	12920	9807	5162	4152	313	4	73	1	2	3	8	5	5	6	9734	73	3113
490215	제주특별자치도	서귀포시	대천동	8437	5680	2882	2468	196	3	52	2	1	0	5	9	2	2	5622	58	2757
490216	제주특별자치도	서귀포시	중문동	9476	6677	3512	2766	228	6	57	0	1	0	2	7	3	7	6589	88	2799
490217	제주특별자치도	서귀포시	예래동	3024	2096	1010	968	56	2	24	1	0	2	1	4	1	2	2071	25	928
510101	세종특별자치시	세종특별자치시	조치원읍	31032	20910	9666	10152	576	18	231	4	4	5	24	25	10	10	20725	185	10122
510102	세종특별자치시	세종특별자치시	연기면	3557	2819	1349	1346	63	1	38	2	0	0	2	1	0	1	2803	16	738
510103	세종특별자치시	세종특별자치시	연동면	2668	1993	728	1181	34	0	13	1	0	1	7	3	3	2	1973	20	675
510104	세종특별자치시	세종특별자치시	부강면	5312	3881	1719	1968	92	2	55	1	0	0	3	4	1	2	3847	34	1431
510105	세종특별자치시	세종특별자치시	금남면	7412	5422	2131	3050	127	4	49	1	1	0	1	4	7	2	5377	45	1990
510106	세종특별자치시	세종특별자치시	전의면	4791	3452	1368	1909	87	1	42	2	0	1	2	4	3	2	3421	31	1339
510107	세종특별자치시	세종특별자치시	전동면	2960	1981	731	1161	46	0	14	0	1	1	4	0	1	6	1965	16	979
510108	세종특별자치시	세종특별자치시	소정면	1907	1374	496	810	37	0	14	1	0	0	2	1	0	0	1361	13	533
510109	세종특별자치시	세종특별자치시	장군면	5705	3931	1796	1974	73	3	36	0	0	1	5	7	1	1	3897	34	1774
510110	세종특별자치시	세종특별자치시	연서면	7349	5581	2620	2737	101	2	51	1	0	3	6	8	4	4	5537	44	1768
510111	세종특별자치시	세종특별자치시	한솔동	12258	10184	5599	4140	311	0	46	3	0	2	5	5	0	3	10114	70	2074
510112	세종특별자치시	세종특별자치시	도담동	20920	16618	8589	7238	535	11	83	5	3	5	4	10	1	8	16492	126	4302
510113	세종특별자치시	세종특별자치시	아름동	15034	12542	7361	4594	433	2	52	2	0	1	3	7	7	3	12465	77	2492
510114	세종특별자치시	세종특별자치시	종촌동	19385	15674	8662	6362	445	4	86	2	1	7	6	10	2	3	15590	84	3711
510115	세종특별자치시	세종특별자치시	고운동	19800	15230	8489	6058	452	6	105	2	1	4	9	9	0	6	15141	89	4570
510116	세종특별자치시	세종특별자치시	보람동	12687	10415	5632	4295	330	3	52	2	2	4	2	6	3	2	10333	82	2272
510117	세종특별자치시	세종특별자치시	새롬동	23050	18210	9557	7854	545	5	110	2	1	0	7	15	0	3	18099	111	4840
510118	세종특별자치시	세종특별자치시	대평동	8285	6768	3497	2972	206	2	27	0	0	0	2	7	0	2	6715	53	1517
510119	세종특별자치시	세종특별자치시	소담동	13183	10787	5926	4392	320	4	61	1	0	0	3	6	4	2	10719	68	2396
510120	세종특별자치시	세종특별자치시	다정동	18638	14980	8046	6199	503	4	89	3	1	4	6	6	0	0	14861	119	3658
510121	세종특별자치시	세종특별자치시	해밀동	5477	4589	2670	1726	140	2	19	0	1	1	1	5	1	1	4567	22	888
510122	세종특별자치시	세종특별자치시	반곡동	13197	10594	5631	4415	363	6	62	2	1	2	0	8	1	3	10494	100	2603
